Transaction ID,Posting Date,Effective Date,Transaction Type,Amount,Check Number,Reference Number,Description,Transaction Category,Type,Balance
20170630 642246 304 2017063026270,6/30/2017,6/30/2017,Credit,3.04,,363579603,Credit Dividend,,,4509.31
20170630 642246 250 2017063026268,6/30/2017,6/30/2017,Credit,2.5,,363579605,ATM Rebate ATM Fee Refund,,,4546.27
20170630 642246 2500 2017063026267,6/30/2017,6/30/2017,Check,-25,6089,363579606,Check #6089,,Checks,4543.77
20170630 642246 1500 2017063026266,6/30/2017,6/30/2017,Check,-15,6090,363579607,Check #6090,,Checks,4568.77
20170630 642246 3597 2017063026265,6/30/2017,6/30/2017,Debit,-35.97,,363381579,POS Transaction ORCHARD SUPPLY #761 10860 SW BARNES RD     PORTLAND     ORUS,,Debit Card,4583.77
20170630 642246 2599 2017063026264,6/30/2017,6/30/2017,Debit,-25.99,,363381580,POS Transaction 100061408 WALGREENS 1620 NE GRAN PORTLAND     ORUS,Health & Fitness,Debit Card,4619.74
20170630 642246 3600 2017063026262,6/30/2017,6/30/2017,Debit,-36,,363381581,POS Transaction METRO CENTRAL SW DISPO 6161 NW 61ST AVE       PORTLAND     O,,Debit Card,4645.73
20170630 642246 1047 2017063026261,6/30/2017,6/30/2017,Debit,-10.47,,363156822,POS Transaction MARKET OF CHOICE #2 250 NW LOST SRPINGS TERPORTLAND     ORUS,,Debit Card,4681.73
20170630 642246 3875 2017063026260,6/30/2017,6/30/2017,Debit,-38.75,,363088324,POS Transaction 1006 JAKE CRAW FISH 401 SW 12TH AVE        BELLEVUE     WAUS,,Debit Card,4692.2
20170630 642246 499 2017063026259,6/30/2017,6/30/2017,Debit,-4.99,,363088325,POS Transaction Amazon Services-Kindle 440 Terry Ave N        866-321-8851 W,Shopping,Debit Card,4730.95
20170630 642246 479341 2017063026258,6/30/2017,6/30/2017,Credit,4793.41,,363088326,ACH Deposit HEALTH AUTHORITY STATE OF OREGON - DIRECT DEP,,ACH,4735.94
20170630 642246 856 2017063026257,6/30/2017,6/30/2017,Debit,-8.56,,363088327,POS Transaction ORCHARD SUPPLY #761 10860 SW BARNES RD     PORTLAND     ORUS,,Debit Card,-57.47
20170629 642246 1544 2017062926256,6/29/2017,6/29/2017,Debit,-15.44,,362964877,POS Transaction 14022186 PAPYRUS # 9374 SW WASH TIGARD       ORUS,,Debit Card,-48.91
20170629 642246 747 2017062926255,6/29/2017,6/29/2017,Debit,-7.47,,362964878,POS Transaction PAPYRUS #2218 9374 SW WASHINGTON SQUATIGARD       ORUS,,Debit Card,-33.47
20170629 642246 2600 2017062926254,6/29/2017,6/29/2017,Debit,-26,,362964879,POS Transaction 720000147384 SEPHORA 192 9329 SW WS PORTLAND     ORUS,Personal Care,Debit Card,-26
20170629 642246 32737 2017062926253,6/29/2017,6/29/2017,Credit,327.37,,362917103,Overdraft Transfer,Transfer,Transfer,0
20170629 642246 6548 2017062926252,6/29/2017,6/29/2017,Debit,-65.48,,362917104,POS Transaction TWIN OAKS NURSERY LLC 10990 SW RIVER RD      HILLSBOROUGH OR,,Debit Card,-327.37
20170629 642246 230 2017062926251,6/29/2017,6/29/2017,Debit,-2.3,,362917105,POS Transaction CITY OF PORTLAND DEPT 1120 SW 5TH AVE STE    PORTLAND     OR,,Debit Card,-261.89
20170629 642246 3683 2017062926250,6/29/2017,6/29/2017,Debit,-36.83,,362917106,POS Transaction ARROWHEAD TRAVEL PLA 72485 HIGHWAY 331      PENDLETON    ORU,,Debit Card,-259.59
20170629 642246 2000 2017062926249,6/29/2017,6/29/2017,Debit,-20,,362917107,POS Transaction FRED M FUEL #9661 Q76 22075 NW IMBRIE DR     HILLSBORO    OR,,Debit Card,-222.76
20170629 642246 199 2017062926248,6/29/2017,6/29/2017,Debit,-1.99,,362747320,POS Transaction GOOGLE *Google Storage 1600 Amphitheatre Pkwy 855-836-3987 C,Entertainment,Debit Card,-202.76
20170628 642246 33000 2017062826247,6/28/2017,6/28/2017,Debit,-330,,362747321,ACH Debit BANK OF AMERICA FIRST TECH FCU B - BILL PAYMT,,ACH,-200.77
20170628 642246 3273 2017062826246,6/28/2017,6/28/2017,Credit,32.73,,362747322,Credit AMAZON.COM REFUNDAMAZON.COM       SEATTLE      WAUS,,,129.23
20170628 642246 713 2017062826245,6/28/2017,6/28/2017,Debit,-7.13,,362747323,POS Transaction PETSMART # 0384 12375 SW WALKER ROAD   BEAVERTON    ORUS,Pets,Debit Card,96.5
20170628 642246 2654 2017062826244,6/28/2017,6/28/2017,Debit,-26.54,,362747324,POS Transaction 9097139 FRED MEYE FRED MEYER 6 HILLSBORO    ORUS,,Debit Card,103.63
20170628 642246 250 2017062826243,6/28/2017,6/28/2017,Debit,-2.5,,362546507,POS Transaction FARMINGTON GARDENS 26985 S.W. FARMING     HILLSBORO    ORUS,,Debit Card,130.17
20170628 642246 1500 2017062826242,6/28/2017,6/28/2017,Debit,-15,,362546508,POS Transaction 76 - UNITED PACIFIC 54 2420 SW CEDAR HILLS    BEAVERTON    O,,Debit Card,132.67
20170628 642246 1108 2017062826241,6/28/2017,6/28/2017,Debit,-11.08,,362546509,POS Transaction QUALITY FOOD CEN 7525 SW BARNES RD      PORTLAND     ORUS,,Debit Card,147.67
20170628 642246 2460 2017062826240,6/28/2017,6/28/2017,Debit,-24.6,,362546510,POS Transaction M & W EXPRESS 101 THUNDEREGG BLVD    NYSSA        ORUS,Shopping,Debit Card,158.75
20170628 642246 1998 2017062826239,6/28/2017,6/28/2017,Debit,-19.98,,362488068,POS Transaction MIKES AUTO PARTS INC 12505 NW Cornell Rd    PORTLAND     ORU,,Debit Card,183.35
20170628 642246 1000 2017062826238,6/28/2017,6/28/2017,Debit,-10,,362488069,POS Transaction SHELL OIL 536678407QPS 9920 N.E. SANDY BLVD   PORTLAND     O,Auto & Transport,Debit Card,203.33
20170628 642246 11399 2017062826237,6/28/2017,6/28/2017,Debit,-113.99,,362488070,POS Transaction 324016262994 AT&T SP26 6316         BEAVERTON    ORUS,Bills & Utilities,Debit Card,213.33
20170628 642246 200 2017062826236,6/28/2017,6/28/2017,Debit,-2,,362488071,POS Transaction MARKET OF CHOICE #2 250 NW LOST SRPINGS TERPORTLAND     ORUS,,Debit Card,327.32
20170627 642246 2882 2017062726235,6/27/2017,6/27/2017,Check,-28.82,6088,362317717,Electronic Check ORCHARD SUPPLY PURCHASE PORT OR SERIAL #: 6088,,Checks,329.32
20170627 642246 3903 2017062726234,6/27/2017,6/27/2017,Debit,-39.03,,362317718,POS Transaction  AMAZON.COM             SEATTLE      WAUS,,Debit Card,358.14
20170627 642246 10000 2017062726233,6/27/2017,6/27/2017,Debit,-100,,362226802,Withdrawal Chapman Pmt from 4076823 CK,,Withdrawal,397.17
20170627 642246 37307 2017062726232,6/27/2017,6/27/2017,Debit,-373.07,,362225391,Withdrawal Transfer From 4076823,Transfer,Withdrawal,497.17
20170627 642246 1450 2017062726231,6/27/2017,6/27/2017,Debit,-14.5,,362222590,POS Transaction THE MUTTLEY CREW 806 NW Murray Blvd     PORTLAND     ORUS,,Debit Card,870.24
20170627 642246 4416 2017062726230,6/27/2017,6/27/2017,Debit,-44.16,,362222591,POS Transaction ARROWHEAD TRAVEL PLA 72485 HIGHWAY 331      PENDLETON    ORU,,Debit Card,884.74
20170627 642246 725 2017062726229,6/27/2017,6/27/2017,Debit,-7.25,,362222592,POS Transaction SUBWAY        00137927 1465 SW 4TH AVENUE     ONTARIO      O,Food & Dining,Debit Card,928.9
20170627 642246 5894 2017062726228,6/27/2017,6/27/2017,Debit,-58.94,,362083823,POS Transaction 178006028991 IKEA PORTLAND          PORTLAND     ORUS,Home,Debit Card,936.15
20170627 642246 1298 2017062726226,6/27/2017,6/27/2017,Debit,-12.98,,362083825,POS Transaction QUALITY FOOD CEN 7525 SW BARNES RD      PORTLAND     ORUS,,Debit Card,1013.08
20170626 642246 1799 2017062626227,6/26/2017,6/26/2017,Check,-17.99,6086,362083824,Check #6086,,Checks,995.09
20170626 642246 29288 2017062626225,6/26/2017,6/26/2017,Debit,-292.88,,362083826,ACH Debit BKAMERICA  - IC PAYMENT,,ACH,1026.06
20170626 642246 800 2017062626224,6/26/2017,6/26/2017,Debit,-8,,362083827,POS Transaction LAURELHURST THEATER & 2735 E BURNSIDE ST     00001        OR,,Debit Card,1318.94
20170626 642246 2250 2017062626223,6/26/2017,6/26/2017,Debit,-22.5,,362083828,ATM Withdrawal M AND W MARK-317082 101 THUNDEREGG  BOULEVANYSSA        ORUS,,Debit Card,1326.94
20170626 642246 5498 2017062626222,6/26/2017,6/26/2017,Debit,-54.98,,362083829,POS Transaction H&M022 9591 SW WASHINGTON SQUAPORTLAND     ORUS,,Debit Card,1349.44
20170626 642246 5700 2017062626221,6/26/2017,6/26/2017,Debit,-57,,362083830,POS Transaction RIVER CITY FLY SHOP 11429 SW SCHOLLS FER   BEAVERTON    ORUS,,Debit Card,1404.42
20170626 642246 1299 2017062626220,6/26/2017,6/26/2017,Debit,-12.99,,361804479,"POS Transaction Audible US 1 Washington Park, 16th888-283-5051 NJUS",,Debit Card,1461.42
20170626 642246 999 2017062626219,6/26/2017,6/26/2017,Debit,-9.99,,361804480,POS Transaction Amazon Services-Kindle 440 Terry Ave N        866-321-8851 W,Shopping,Debit Card,1474.41
20170626 642246 299 2017062626218,6/26/2017,6/26/2017,Debit,-2.99,,361804481,POS Transaction Amazon Services-Kindle 440 Terry Ave N        866-321-8851 W,Shopping,Debit Card,1484.4
20170626 642246 900 2017062626217,6/26/2017,6/26/2017,Debit,-9,,361804482,Withdrawal Transfer From 4076823 9,Transfer,Withdrawal,1487.39
20170626 642246 599 2017062626216,6/26/2017,6/26/2017,Debit,-5.99,,361702120,POS Transaction 427736 VANS #168              TIGARD       ORUS,,Debit Card,1496.39
20170626 642246 6200 2017062626215,6/26/2017,6/26/2017,Debit,-62,,361702121,POS Transaction 427736 VANS #168              TIGARD       ORUS,,Debit Card,1502.38
20170625 642246 15069 2017062526214,6/25/2017,6/25/2017,Debit,-150.69,,361702122,POS Transaction 90929562 NORDSTROM 181 NW EVERG BEAVERTON    ORUS,Shopping,Debit Card,1564.38
20170625 642246 7747 2017062526213,6/25/2017,6/25/2017,Debit,-77.47,,361702123,POS Transaction THE OUTDOORSMAN INC 50 NE 2ND ST           ONTARIO      ORUS,,Debit Card,1715.07
20170625 642246 4937 2017062526212,6/25/2017,6/25/2017,Debit,-49.37,,361702124,POS Transaction J & J CORNER 330 EAST IDAHO ST      ONTARIO      ORUS,,Debit Card,1792.54
20170625 642246 1892 2017062526211,6/25/2017,6/25/2017,Debit,-18.92,,361702125,POS Transaction 80236 LOVES CNTY 372         ONTARIO      ORUS,,Debit Card,1841.91
20170625 642246 800 2017062526210,6/25/2017,6/25/2017,Debit,-8,,361702126,Withdrawal Transfer From 4076823,Transfer,Withdrawal,1860.83
20170625 642246 30000 2017062526209,6/25/2017,6/25/2017,Debit,-300,,361702127,Withdrawal Transfer From 4076823 Vacation #CT,Transfer,Withdrawal,1868.83
20170624 642246 2698 2017062426208,6/24/2017,6/24/2017,Debit,-26.98,,361608136,POS Transaction 1405308 QUALITY F 7525 SW BARN PORTLAND     ORUS,,Debit Card,2168.83
20170624 642246 3273 2017062426207,6/24/2017,6/24/2017,Debit,-32.73,,361608137,POS Transaction  AMAZON.COM             SEATTLE      WAUS,,Debit Card,2195.81
20170624 642246 33000 2017062426206,6/24/2017,6/24/2017,Credit,330,,361503899,Deposit Transfer To 4076823,Transfer,,2228.54
20170624 642246 13000 2017062426205,6/24/2017,6/24/2017,Debit,-130,,361501494,Withdrawal Transfer From 4076823,Transfer,Withdrawal,1898.54
20170624 642246 3888 2017062426204,6/24/2017,6/24/2017,Debit,-38.88,,361493504,POS Transaction ARCO CORNELL 06501 15320 NW CORNELL RD    BEAVERTON    ORUS,,Debit Card,2028.54
20170624 642246 500 2017062426203,6/24/2017,6/24/2017,Debit,-5,,361493505,POS Transaction DOLLAR TREE 13575 NW CORNELL RD    PORTLAND     ORUS,,Debit Card,2067.42
20170624 642246 798 2017062426202,6/24/2017,6/24/2017,Debit,-7.98,,361493506,POS Transaction 72000005038 FISHERMAN'S MARINE OUT TIGARD       ORUS,,Debit Card,2072.42
20170624 642246 17185 2017062426201,6/24/2017,6/24/2017,Debit,-171.85,,361493507,POS Transaction 9115596 WINCO FOO 7330 Nw Butl Hillsboro    ORUS,,Debit Card,2080.4
20170624 642246 1318 2017062426200,6/24/2017,6/24/2017,Debit,-13.18,,361493508,POS Transaction NEW SEASON MARKET -#3 1453 NE 61ST AVE       HILLSBORO    OR,,Debit Card,2252.25
20170624 642246 600 2017062426199,6/24/2017,6/24/2017,Debit,-6,,361493509,POS Transaction SUNRISE BAGELS 10902 SW BARNES RD     PORTLAND     ORUS,,Debit Card,2265.43
20170624 642246 10200 2017062426198,6/24/2017,6/24/2017,Debit,-102,,361493510,POS Transaction SQ *SALON JULES BEA 12577 SW 1ST ST        BEAVERTON    ORUS,,Debit Card,2271.43
20170624 642246 2004 2017062426197,6/24/2017,6/24/2017,Debit,-20.04,,361493511,POS Transaction THE HOME DEPOT #4001 13700 NS SCIENCE PARK DPORTLAND     ORU,Home,Debit Card,2373.43
20170624 642246 2800 2017062426196,6/24/2017,6/24/2017,Debit,-28,,361493512,POS Transaction LAURELHURST THEATER 2735 E BURNSIDE ST     PORTLAND     ORUS,,Debit Card,2393.47
20170624 642246 1264 2017062426195,6/24/2017,6/24/2017,Debit,-12.64,,361493513,POS Transaction FARMINGTON GARDENS 26985 S.W. FARMING     HILLSBORO    ORUS,,Debit Card,2421.47
20170624 642246 999 2017062426194,6/24/2017,6/24/2017,Debit,-9.99,,361493514,POS Transaction  NETFLIX COM            LOS GATOS    CAUS,,Debit Card,2434.11
20170624 642246 1100 2017062426193,6/24/2017,6/24/2017,Debit,-11,,361493515,POS Transaction THE WESTGATE BOURBON B 3800 SW Cedar Hills BlvBEAVERTON    O,,Debit Card,2444.1
20170623 642246 692 2017062326192,6/23/2017,6/23/2017,Debit,-6.92,,361362987,POS Transaction GREEN ZEBRA #2 - L 808 NE MULTNOMAH       PORTLAND     ORUS,,Debit Card,2455.1
20170623 642246 2000 2017062326191,6/23/2017,6/23/2017,Debit,-20,,361362988,ATM Withdrawal FIRST TECH 800 NE OREGON AVE      PORTLAND     ORUS,,Debit Card,2462.02
20170623 642246 2000 2017062326190,6/23/2017,6/23/2017,Debit,-20,,361117355,POS Transaction TOPGOLF HILLSBORO 027- NW BROOKWOOD PKWY      HILLSBORO    O,,Debit Card,2482.02
20170623 642246 4800 2017062326189,6/23/2017,6/23/2017,Debit,-48,,361117356,POS Transaction EASYSTREET 9705 SW SUNSHINE COURT 5036468400   ORUS,,Debit Card,2502.02
20170623 642246 2000 2017062326188,6/23/2017,6/23/2017,Debit,-20,,361117357,POS Transaction HARRY'S 888-212-6855 78 IRVING PLACE        8882126855   NYU,,Debit Card,2550.02
20170623 642246 200 2017062326187,6/23/2017,6/23/2017,Debit,-2,,361117358,POS Transaction CITY OF PORTLAND DEPT 1120 SW 5TH AVE STE    PORTLAND     OR,,Debit Card,2570.02
20170623 642246 4163 2017062326186,6/23/2017,6/23/2017,Debit,-41.63,,361117359,POS Transaction FRED M FUEL #9661 Q76 22075 NW IMBRIE DR     HILLSBORO    OR,,Debit Card,2572.02
20170623 642246 200 2017062326185,6/23/2017,6/23/2017,Debit,-2,,361117360,POS Transaction CITY OF PORTLAND DEPT 1120 SW 5TH AVE STE    PORTLAND     OR,,Debit Card,2613.65
20170623 642246 2168 2017062326184,6/23/2017,6/23/2017,Debit,-21.68,,360972596,POS Transaction 1405308 QUALITY F 7525 SW BARN PORTLAND     ORUS,,Debit Card,2615.65
20170622 642246 13391 2017062226183,6/22/2017,6/22/2017,Debit,-133.91,,360972597,ACH Debit FEDLOANSERVICING ACH TRANSACTION - STDNT LOAN,,ACH,2637.33
20170622 642246 12015 2017062226182,6/22/2017,6/22/2017,Debit,-120.15,,360972598,ACH Debit USAA.COM PAY EXT ACH PAYMENTS - LIFE,,ACH,2771.24
20170622 642246 789 2017062226181,6/22/2017,6/22/2017,Debit,-7.89,,360972599,POS Transaction QUALITY FOOD CEN 7525 SW BARNES RD      PORTLAND     ORUS,,Debit Card,2891.39
20170622 642246 799 2017062226180,6/22/2017,6/22/2017,Debit,-7.99,,360972600,POS Transaction  AMAZON.COM             SEATTLE      WAUS,,Debit Card,2899.28
20170622 642246 1845 2017062226179,6/22/2017,6/22/2017,Debit,-18.45,,360972601,POS Transaction PIZZA SCHMIZZA - PORTL 7535 SW BARNES RD STE 1PORTLAND     O,,Debit Card,2907.27
20170622 642246 36212 2017062226178,6/22/2017,6/22/2017,Debit,-362.12,,360972602,POS Transaction THE TIRE RACK 7101 Vorden Pkwy       800-428-8355 INUS,,Debit Card,2925.72
20170622 642246 1899 2017062226177,6/22/2017,6/22/2017,Debit,-18.99,,360972603,POS Transaction  AMAZON.COM             SEATTLE      WAUS,,Debit Card,3287.84
20170622 642246 2599 2017062226176,6/22/2017,6/22/2017,Debit,-25.99,,360972604,POS Transaction  AMAZON.COM             SEATTLE      WAUS,,Debit Card,3306.83
20170622 642246 33500 2017062226175,6/22/2017,6/22/2017,Debit,-335,,360972605,Withdrawal Transfer From 4076823,Transfer,Withdrawal,3332.82
20170622 642246 5000 2017062226174,6/22/2017,6/22/2017,Debit,-50,,360972606,Withdrawal Transfer From 4076823,Transfer,Withdrawal,3667.82
20170622 642246 40000 2017062226173,6/22/2017,6/22/2017,Debit,-400,,360972607,Withdrawal Transfer From 4076823,Transfer,Withdrawal,3717.82
20170622 642246 5000 2017062226172,6/22/2017,6/22/2017,Debit,-50,,360972608,Withdrawal Transfer From 4076823,Transfer,Withdrawal,4117.82
20170622 642246 35000 2017062226171,6/22/2017,6/22/2017,Debit,-350,,360972609,Withdrawal Transfer From 4076823 Pay off this SOB!,Transfer,Withdrawal,4167.82
20170622 642246 1591 2017062226169,6/22/2017,6/22/2017,Debit,-15.91,,360755630,POS Transaction THE HOME DEPOT #4001 13700 NS SCIENCE PARK DPORTLAND     ORU,Home,Debit Card,4597.82
20170622 642246 4000 2017062226168,6/22/2017,6/22/2017,Debit,-40,,360755631,POS Transaction ARCO CORNELL 06501 15320 NW CORNELL RD    BEAVERTON    ORUS,,Debit Card,4613.73
20170621 642246 8000 2017062126170,6/21/2017,6/21/2017,Check,-80,6087,360755629,Check #6087,,Checks,4517.82
20170621 642246 557 2017062126167,6/21/2017,6/21/2017,Debit,-5.57,,360630341,POS Transaction GREEN ZEBRA #2 - L 808 NE MULTNOMAH       PORTLAND     ORUS,,Debit Card,4653.73
20170621 642246 800 2017062126166,6/21/2017,6/21/2017,Debit,-8,,360630342,POS Transaction SQ *KAADY CAR WASHE 14740 NORTHWEST CORNELLPORTLAND     ORUS,,Debit Card,4659.3
20170621 642246 1350 2017062126165,6/21/2017,6/21/2017,Debit,-13.5,,360630343,POS Transaction PIZZA SCHMIZZA - PORTL 7535 SW BARNES RD STE 1PORTLAND     O,,Debit Card,4667.3
20170621 642246 4897 2017062126164,6/21/2017,6/21/2017,Debit,-48.97,,360426121,POS Transaction  AMAZON.COM             SEATTLE      WAUS,,Debit Card,4680.8
20170620 642246 917 2017062026163,6/20/2017,6/20/2017,Check,-9.17,6085,360283248,Electronic Check NEW SEASONS #8 PURCHASE BEAV OR SERIAL #: 6085,,Checks,4729.77
20170620 642246 500 2017062026162,6/20/2017,6/20/2017,Debit,-5,,360283249,ACH Debit OPB  - DONATION,,ACH,4738.94
20170620 642246 1310 2017062026161,6/20/2017,6/20/2017,Debit,-13.1,,360283250,POS Transaction 14151191 DOLLAR TR 12635 SW WAL BEAVERTON    ORUS,,Debit Card,4743.94
20170620 642246 475704 2017062026160,6/20/2017,6/20/2017,Credit,4757.04,,360143356,ACH Deposit BEAVERTON SCHOOL PAYROLL 1701006 - PAYROLL,,ACH,4757.04
20170619 642246 3106 2017061926159,6/19/2017,6/19/2017,Credit,31.06,,360027998,Overdraft Transfer,Transfer,Transfer,0
20170619 642246 1109 2017061926158,6/19/2017,6/19/2017,Debit,-11.09,,360027999,POS Transaction 2450001612 SAFEWAY  STORE  1612   PORTLAND     ORUS,,Debit Card,-31.06
20170619 642246 2000 2017061926157,6/19/2017,6/19/2017,Debit,-20,,359759370,POS Transaction 76 - UNITED PACIFIC 54 2420 SW CEDAR HILLS    BEAVERTON    O,,Debit Card,-19.97
20170619 642246 3100 2017061926156,6/19/2017,6/19/2017,Debit,-31,,359726826,POS Transaction GROUPON INC 600 W Chicago Ave      877-788-7858 ILUS,,Debit Card,0.03
20170619 642246 2904 2017061926155,6/19/2017,6/19/2017,Debit,-29.04,,359726827,POS Transaction PERFORMANCE BIKE SHOP 3850 SW Hall Blvd      BEAVERTON    OR,,Debit Card,31.03
20170618 642246 12590 2017061826154,6/18/2017,6/18/2017,Debit,-125.9,,359627598,POS Transaction 90739706 WINCO #01 3025 SW Ceda Beaverton    ORUS,,Debit Card,60.07
20170618 642246 1262 2017061826153,6/18/2017,6/18/2017,Debit,-12.62,,359627599,POS Transaction 90739706 WINCO #01 3025 SW Ceda Beaverton    ORUS,,Debit Card,185.97
20170618 642246 1414 2017061826152,6/18/2017,6/18/2017,Debit,-14.14,,359531399,POS Transaction 90739706 WINCO #01 3025 SW Ceda Beaverton    ORUS,,Debit Card,198.59
20170618 642246 3436 2017061826151,6/18/2017,6/18/2017,Debit,-34.36,,359531400,POS Transaction 1405308 QUALITY F 7525 SW BARN PORTLAND     ORUS,,Debit Card,212.73
20170618 642246 800 2017061826150,6/18/2017,6/18/2017,Debit,-8,,359531401,Withdrawal Transfer From 4076823,Transfer,Withdrawal,247.09
20170617 642246 1400 2017061726149,6/17/2017,6/17/2017,Debit,-14,,359480202,POS Transaction LA BELLE NAILS TOO LLC 230 NW LOST SPRINGS TERPORTLAND     O,,Debit Card,255.09
20170617 642246 200 2017061726148,6/17/2017,6/17/2017,Debit,-2,,359480203,POS Transaction CITY OF PORTLAND DEPT 1120 SW 5TH AVE STE    PORTLAND     OR,,Debit Card,269.09
20170617 642246 200 2017061726147,6/17/2017,6/17/2017,Debit,-2,,359480204,POS Transaction CITY OF PORTLAND DEPT 1120 SW 5TH AVE STE    PORTLAND     OR,,Debit Card,271.09
20170617 642246 2000 2017061726146,6/17/2017,6/17/2017,Debit,-20,,359297475,POS Transaction 76 - 76 OF CANYON 12075 SW CANYON RD     BEAVERTON    ORUS,,Debit Card,273.09
20170617 642246 269 2017061726145,6/17/2017,6/17/2017,Debit,-2.69,,359297476,POS Transaction MARKET OF CHOICE #2 250 NW LOST SRPINGS TERPORTLAND     ORUS,,Debit Card,293.09
20170617 642246 7198 2017061726144,6/17/2017,6/17/2017,Credit,71.98,,359297477,Credit AMAZON.COM REFUNDAMAZON.COM       SEATTLE      WAUS,,,295.78
20170617 642246 700 2017061726143,6/17/2017,6/17/2017,Debit,-7,,359297478,POS Transaction POSTAL ANNEX #190 INC. 7327 SW BARNES RD      PORTLAND     O,,Debit Card,223.8
20170617 642246 3194 2017061726142,6/17/2017,6/17/2017,Debit,-31.94,,359171335,POS Transaction ORCHARD SUPPLY #761 10860 SW BARNES RD     PORTLAND     ORUS,,Debit Card,230.8
20170617 642246 3579 2017061726141,6/17/2017,6/17/2017,Debit,-35.79,,359171336,POS Transaction 1405308 QUALITY F 7525 SW BARN PORTLAND     ORUS,,Debit Card,262.74
20170616 642246 1700 2017061626140,6/16/2017,6/16/2017,Debit,-17,,359171337,POS Transaction 226030101993 COLUMBIA SPORTSWEAR 42 PORTLAND     ORUS,,Debit Card,298.53
20170616 642246 125 2017061626139,6/16/2017,6/16/2017,Debit,-1.25,,359171338,POS Transaction CITY OF PORTLAND DEPT 1120 SW 5TH AVE STE    PORTLAND     OR,,Debit Card,315.53
20170616 642246 1000 2017061626138,6/16/2017,6/16/2017,Credit,10,,359171339,ACH Deposit ALLEGIANCE BENEF PRETAX BENEFIT TRANS - CLAIM REIM,,ACH,316.78
20170616 642246 200 2017061626137,6/16/2017,6/16/2017,Debit,-2,,358932200,POS Transaction CITY OF PORTLAND DEPT 1120 SW 5TH AVE STE    PORTLAND     OR,,Debit Card,306.78
20170616 642246 650 2017061626136,6/16/2017,6/16/2017,Debit,-6.5,,358932201,POS Transaction MARKET OF CHOICE #2 250 NW LOST SRPINGS TERPORTLAND     ORUS,,Debit Card,308.78
20170615 642246 1033 2017061526135,6/15/2017,6/15/2017,Debit,-10.33,,358932202,ACH Debit SAFECO INSURANCE  - INS PREM,,ACH,315.28
20170615 642246 2000 2017061526134,6/15/2017,6/15/2017,Debit,-20,,358627339,ATM Withdrawal FIRST TECH 800 NE OREGON AVE      PORTLAND     ORUS,,Debit Card,325.61
20170615 642246 899 2017061526133,6/15/2017,6/15/2017,Debit,-8.99,,358615269,POS Transaction Amazon Services-Kindle 440 Terry Ave N        866-321-8851 W,Shopping,Debit Card,345.61
20170615 642246 11743 2017061526132,6/15/2017,6/15/2017,Debit,-117.43,,358615270,"POS Transaction PARTS GEEK, LLC 3203 ATLANTIC AVE      800-5419352  NJUS",,Debit Card,354.6
20170615 642246 3298 2017061526131,6/15/2017,6/15/2017,Credit,32.98,,358605215,Deposit Shared Branch Mobile Deposit          First Tech FC CA,,,472.03
20170615 642246 30000 2017061526130,6/15/2017,6/15/2017,Credit,300,,358490307,Deposit Transfer To 4076823,Transfer,,439.05
20170615 642246 980000 2017061526129,6/15/2017,6/15/2017,Debit,-9800,,358490182,Withdrawal Transfer From 4076823,Transfer,Withdrawal,139.05
20170614 642246 16159 2017061426128,6/14/2017,6/14/2017,Debit,-161.59,,358489257,ACH Debit PROG UNIVERSAL BRANCH16DEBIT  ACH - INS PREM,,ACH,9939.05
20170614 642246 225 2017061426127,6/14/2017,6/14/2017,Debit,-2.25,,358343747,POS Transaction OREGON PARKING PORTLAN 1225 FERRY ST SE # U   SALEM        O,,Debit Card,10100.64
20170614 642246 150 2017061426126,6/14/2017,6/14/2017,Debit,-1.5,,358343748,POS Transaction CITY OF PORTLAND DEPT 1120 SW 5TH AVE STE    PORTLAND     OR,,Debit Card,10102.89
20170614 642246 1320 2017061426125,6/14/2017,6/14/2017,Debit,-13.2,,358343749,POS Transaction PHARMACA INTEGRATIVE P 240 NW LOST SPRINGS TERPORTLAND     O,,Debit Card,10104.39
20170614 642246 2000 2017061426124,6/14/2017,6/14/2017,Debit,-20,,358343750,POS Transaction ARCO#06501         QPS 15320 NW CORNELL RD    BEAVERTON    O,,Debit Card,10117.59
20170614 642246 1946 2017061426123,6/14/2017,6/14/2017,Debit,-19.46,,358343751,POS Transaction MARKET OF CHOICE #2 250 NW LOST SRPINGS TERPORTLAND     ORUS,,Debit Card,10137.59
20170614 642246 1042 2017061426122,6/14/2017,6/14/2017,Debit,-10.42,,358343752,POS Transaction QUALITY FOOD CEN 7525 SW BARNES RD      PORTLAND     ORUS,,Debit Card,10157.05
20170614 642246 200 2017061426121,6/14/2017,6/14/2017,Debit,-2,,358343753,POS Transaction QUALITY FOOD CEN 7525 SW BARNES RD      PORTLAND     ORUS,,Debit Card,10167.47
20170614 642246 499 2017061426120,6/14/2017,6/14/2017,Debit,-4.99,,358343754,POS Transaction QUALITY FOOD CEN 7525 SW BARNES RD      PORTLAND     ORUS,,Debit Card,10169.47
20170613 642246 15000 2017061326119,6/13/2017,6/13/2017,Check,-150,6096,358343755,Electronic Check YOUNG LIFE (CHECKPYMT) Accounts Receivable Entry SERIAL #: 6096,,Checks,10174.46
20170613 642246 15000 2017061326118,6/13/2017,6/13/2017,Check,-150,6068,358343756,Electronic Check YOUNG LIFE (CHECKPYMT) Accounts Receivable Entry SERIAL #: 6068,,Checks,10324.46
20170613 642246 1000000 2017061326117,6/13/2017,6/13/2017,Credit,10000,,358343757,Deposit,,,10474.46
20170612 642246 900 2017061226116,6/12/2017,6/12/2017,Debit,-9,,357791828,Withdrawal Transfer From 4076823 9,Transfer,Withdrawal,474.46
20170612 642246 1000 2017061226115,6/12/2017,6/12/2017,Debit,-10,,357739340,Withdrawal Transfer From 4076823,Transfer,Withdrawal,483.46
20170612 642246 50000 2017061226114,6/12/2017,6/12/2017,Credit,500,,357735058,Deposit Transfer To 4076823,Transfer,,493.46
20170612 642246 654 2017061226113,6/12/2017,6/12/2017,Check,-6.54,6083,357734393,Electronic Check NEW SEASONS #18 PURCHASE PORT OR SERIAL #: 6083,,Checks,-6.54
20170612 642246 38245 2017061226112,6/12/2017,6/12/2017,Credit,382.45,,357734394,Overdraft Transfer,Transfer,Transfer,0
20170612 642246 3298 2017061226111,6/12/2017,6/12/2017,Debit,-32.98,,357689865,POS Transaction COSTCO WHSE #0009 15901 SW JENKINS ROAD  ALOHA        ORUS,Shopping,Debit Card,-382.45
20170612 642246 1995 2017061226110,6/12/2017,6/12/2017,Debit,-19.95,,357689866,POS Transaction BEST BUY LANDSCAPE SUP 2200 NW CORNELIUS PASS HILLSBORO    O,,Debit Card,-349.47
20170612 642246 499 2017061226109,6/12/2017,6/12/2017,Debit,-4.99,,357689867,POS Transaction MIKES AUTO PARTS INC 12505 NW Cornell Rd    PORTLAND     ORU,,Debit Card,-329.52
20170612 642246 2870 2017061226108,6/12/2017,6/12/2017,Debit,-28.7,,357689868,POS Transaction THE HOME DEPOT #4001 13700 NS SCIENCE PARK DPORTLAND     ORU,Home,Debit Card,-324.53
20170612 642246 100 2017061226107,6/12/2017,6/12/2017,Debit,-1,,357689869,POS Transaction THE HOME DEPOT #4001 13700 NS SCIENCE PARK DPORTLAND     ORU,Home,Debit Card,-295.83
20170612 642246 250 2017061226106,6/12/2017,6/12/2017,Debit,-2.5,,357689870,POS Transaction BEAVERTON BAKERY 12375 SW BROADWAY ST   BEAVERTON    ORUS,,Debit Card,-294.83
20170612 642246 5700 2017061226105,6/12/2017,6/12/2017,Debit,-57,,357689871,POS Transaction THE DESSERT TRAY 11950 SW BROADWAY ST   BEAVERTON    ORUS,,Debit Card,-292.33
20170612 642246 3358 2017061226104,6/12/2017,6/12/2017,Debit,-33.58,,357689872,POS Transaction MOD PIZZA CEDAR HILLS 2695 SW Cedar Hills BlvBEAVERTON    OR,,Debit Card,-235.33
20170612 642246 9995 2017061226103,6/12/2017,6/12/2017,Debit,-99.95,,357491739,POS Transaction PAYPAL *BLACK SHEEP 2211 North First StreetSan Jose     CAUS,Shopping,Debit Card,-201.75
20170612 642246 3268 2017061226102,6/12/2017,6/12/2017,Debit,-32.68,,357491740,POS Transaction AUTOZONE  3705 825 NW MURRAY BLVD     PORTLAND     ORUS,Auto & Transport,Debit Card,-101.8
20170612 642246 2249 2017061226101,6/12/2017,6/12/2017,Debit,-22.49,,357491741,POS Transaction AUTOZONE  3705 825 NW MURRAY BLVD     PORTLAND     ORUS,Auto & Transport,Debit Card,-69.12
20170612 642246 4663 2017061226100,6/12/2017,6/12/2017,Debit,-46.63,,357491742,POS Transaction ARCO CORNELL 06501 15320 NW CORNELL RD    BEAVERTON    ORUS,,Debit Card,-46.63
20170610 642246 35293 2017061026099,6/10/2017,6/10/2017,Credit,352.93,,357329478,Overdraft Transfer,Transfer,Transfer,0
20170610 642246 2949 2017061026098,6/10/2017,6/10/2017,Debit,-29.49,,357329479,POS Transaction 1405308 QUALITY F 7525 SW BARN PORTLAND     ORUS,,Debit Card,-352.93
20170610 642246 300 2017061026097,6/10/2017,6/10/2017,Debit,-3,,357329480,POS Transaction DOLLAR TREE 12635 SW WALKER RD     BEAVERTON    ORUS,,Debit Card,-323.44
20170610 642246 798 2017061026096,6/10/2017,6/10/2017,Debit,-7.98,,357329481,POS Transaction 694141 TRADER JOE'S #         BEAVERTON    ORUS,,Debit Card,-320.44
20170610 642246 225 2017061026095,6/10/2017,6/10/2017,Debit,-2.25,,357329482,POS Transaction OREGON PARKING PORTLAN 1225 FERRY ST SE # U   SALEM        O,,Debit Card,-312.46
20170609 642246 31021 2017060926094,6/9/2017,6/9/2017,Debit,-310.21,,357329483,ACH Debit AT&T / SBC FIRST TECH FCU B - BILL PAYMT,Bills & Utilities,ACH,-310.21
20170609 642246 3142 2017060926093,6/9/2017,6/9/2017,Credit,31.42,,357329484,Overdraft Transfer,Transfer,Transfer,0
20170609 642246 72 2017060926092,6/9/2017,6/9/2017,Debit,-0.72,,357329485,POS Transaction 9115596 WINCO FOO 7330 Nw Butl Hillsboro    ORUS,,Debit Card,-31.42
20170609 642246 16393 2017060926091,6/9/2017,6/9/2017,Debit,-163.93,,357329486,POS Transaction 9115596 WINCO FOO 7330 Nw Butl Hillsboro    ORUS,,Debit Card,-30.7
20170609 642246 3762 2017060926090,6/9/2017,6/9/2017,Debit,-37.62,,357329487,POS Transaction COSTCO GAS #0692 1255 NE 48TH AVE       HILLSBORO    ORUS,Shopping,Debit Card,133.23
20170609 642246 30723 2017060926089,6/9/2017,6/9/2017,Debit,-307.23,,357329488,POS Transaction COSTCO WHSE #0692 1255 NE 48TH AVE       HILLSBORO    ORUS,Shopping,Debit Card,170.85
20170609 642246 200 2017060926088,6/9/2017,6/9/2017,Debit,-2,,357329489,POS Transaction CITY OF PORTLAND DEPT 1120 SW 5TH AVE STE    PORTLAND     OR,,Debit Card,478.08
20170609 642246 1500 2017060926087,6/9/2017,6/9/2017,Debit,-15,,356751282,POS Transaction 76 - CENTURY PETROLEUM 2115 NW TOWN CENTER    BEAVERTON    O,,Debit Card,480.08
20170609 642246 752 2017060926086,6/9/2017,6/9/2017,Debit,-7.52,,356751283,POS Transaction QUALITY FOOD CEN 7525 SW BARNES RD      PORTLAND     ORUS,,Debit Card,495.08
20170609 642246 283 2017060926085,6/9/2017,6/9/2017,Debit,-2.83,,356751284,POS Transaction QUALITY FOOD CEN 7525 SW BARNES RD      PORTLAND     ORUS,,Debit Card,502.6
20170608 642246 28100 2017060826084,6/8/2017,6/8/2017,Debit,-281,,356751285,ACH Debit MULTNOMAH ATHLET FIRST TECH FCU B - BILL PAYMT,,ACH,505.43
20170608 642246 469 2017060826083,6/8/2017,6/8/2017,Debit,-4.69,,356751286,POS Transaction QUALITY FOOD CEN 7525 SW BARNES RD      PORTLAND     ORUS,,Debit Card,786.43
20170608 642246 200 2017060826082,6/8/2017,6/8/2017,Debit,-2,,356479071,POS Transaction CITY OF PORTLAND DEPT 1120 SW 5TH AVE STE    PORTLAND     OR,,Debit Card,791.12
20170608 642246 200 2017060826081,6/8/2017,6/8/2017,Debit,-2,,356414669,POS Transaction CITY OF PORTLAND DEPT 1120 SW 5TH AVE STE    PORTLAND     OR,,Debit Card,793.12
20170608 642246 2471 2017060826080,6/8/2017,6/8/2017,Debit,-24.71,,356414670,POS Transaction 694149 TRADER JOE'S #         HILLSBORO    ORUS,,Debit Card,795.12
20170608 642246 600 2017060826079,6/8/2017,6/8/2017,Debit,-6,,356414671,POS Transaction QUALITY FOOD CEN 7525 SW BARNES RD      PORTLAND     ORUS,,Debit Card,819.83
20170607 642246 419 2017060726078,6/7/2017,6/7/2017,Debit,-4.19,,356414672,POS Transaction MARKET OF CHOICE #2 250 NW LOST SRPINGS TERPORTLAND     ORUS,,Debit Card,825.83
20170607 642246 13437 2017060726077,6/7/2017,6/7/2017,Debit,-134.37,,356414673,ACH Debit PORTLAND GENERAL FIRST TECH FCU B - BILL PAYMT,,ACH,830.02
20170607 642246 10000 2017060726076,6/7/2017,6/7/2017,Debit,-100,,356414674,ACH Debit BANK OF AMERICA FIRST TECH FCU B - BILL PAYMT,,ACH,964.39
20170607 642246 9237 2017060726075,6/7/2017,6/7/2017,Debit,-92.37,,356414675,ACH Debit COMCAST - BEAVER FIRST TECH FCU B - BILL PAYMT,,ACH,1064.39
20170607 642246 5353 2017060726074,6/7/2017,6/7/2017,Debit,-53.53,,356414676,ACH Debit NW NATURAL GAS FIRST TECH FCU B - BILL PAYMT,,ACH,1156.76
20170607 642246 5000 2017060726073,6/7/2017,6/7/2017,Debit,-50,,356414677,ACH Debit BANK OF AMERICA FIRST TECH FCU B - BILL PAYMT,,ACH,1210.29
20170607 642246 2596 2017060726072,6/7/2017,6/7/2017,Debit,-25.96,,356414678,ACH Debit WALKER GARBAGE S FIRST TECH FCU B - BILL PAYMT,,ACH,1260.29
20170607 642246 860 2017060726071,6/7/2017,6/7/2017,Debit,-8.6,,356241803,POS Transaction 2450001525 SAFEWAY  STORE  1525   PORTLAND     ORUS,,Debit Card,1286.25
20170607 642246 4764 2017060726070,6/7/2017,6/7/2017,Debit,-47.64,,356241804,POS Transaction ARCO CORNELL 06501 15320 NW CORNELL RD    BEAVERTON    ORUS,,Debit Card,1294.85
20170607 642246 1617 2017060726069,6/7/2017,6/7/2017,Debit,-16.17,,356241805,POS Transaction 100150714 WALGREENS 13470 NW COR PORTLAND     ORUS,Health & Fitness,Debit Card,1342.49
20170607 642246 17685 2017060726068,6/7/2017,6/7/2017,Debit,-176.85,,356241806,POS Transaction NORDSTROM-RACK #0027 181 NW EVERGREEN PARKWABEAVERTON    ORU,,Debit Card,1358.66
20170607 642246 5000 2017060726067,6/7/2017,6/7/2017,Debit,-50,,356241807,Withdrawal Transfer From 4076823 Scheduled Recurring Transfer,Transfer,Withdrawal,1535.51
20170606 642246 17180 2017060626066,6/6/2017,6/6/2017,Check,-171.8,6082,356241808,Check #6082,,Checks,1585.51
20170606 642246 158470 2017060626065,6/6/2017,6/6/2017,Debit,-1584.7,,355998837,ACH Debit WF HOME MTG ACH - AUTO PAY,,ACH,1757.31
20170606 642246 37365 2017060626064,6/6/2017,6/6/2017,Debit,-373.65,,355998838,ACH Debit USAA P&C EXT  - AUTOPAY,,ACH,3342.01
20170606 642246 3648 2017060626063,6/6/2017,6/6/2017,Check,-36.48,6081,355998839,Electronic Check WALGREENS PURCHASE HILL OR SERIAL #: 6081,Health & Fitness,Checks,3715.66
20170606 642246 2000 2017060626062,6/6/2017,6/6/2017,Debit,-20,,355936474,ATM Withdrawal FIRST TECH 800 NE OREGON AVE      PORTLAND     ORUS,,Debit Card,3752.14
20170606 642246 599 2017060626061,6/6/2017,6/6/2017,Debit,-5.99,,355936475,POS Transaction Amazon Services-Kindle 440 Terry Ave N        866-321-8851 W,Shopping,Debit Card,3772.14
20170606 642246 2554 2017060626058,6/6/2017,6/6/2017,Debit,-25.54,,355747297,POS Transaction 1405308 QUALITY F 7525 SW BARN PORTLAND     ORUS,,Debit Card,3847.7
20170605 642246 4000 2017060526060,6/5/2017,6/5/2017,Check,-40,6078,355747295,Check #6078,,Checks,3778.13
20170605 642246 2957 2017060526059,6/5/2017,6/5/2017,Check,-29.57,6080,355747296,Check #6080,,Checks,3818.13
20170605 642246 575 2017060526057,6/5/2017,6/5/2017,Debit,-5.75,,355747298,POS Transaction GREEN ZEBRA #2 - L 808 NE MULTNOMAH       PORTLAND     ORUS,,Debit Card,3873.24
20170605 642246 2000 2017060526056,6/5/2017,6/5/2017,Debit,-20,,355411359,POS Transaction PAYPAL 7700 EASTPORT PARKWAY  4029357733   CAUS,Shopping,Debit Card,3878.99
20170605 642246 2900 2017060526055,6/5/2017,6/5/2017,Debit,-29,,355411360,POS Transaction PHO NGUYEN INC 4795 SW 77TH AVE       PORTLAND     ORUS,,Debit Card,3898.99
20170605 642246 40645 2017060526054,6/5/2017,6/5/2017,Debit,-406.45,,355350985,Withdrawal Chapman Pmt from 4076823 CK,,Withdrawal,3927.99
20170605 642246 900 2017060526053,6/5/2017,6/5/2017,Debit,-9,,355347066,Withdrawal Transfer From 4076823 9,Transfer,Withdrawal,4334.44
20170604 642246 14225 2017060426052,6/4/2017,6/4/2017,Debit,-142.25,,355238590,POS Transaction ORCHARD SUPPLY #761 10860 SW BARNES RD     PORTLAND     ORUS,,Debit Card,4343.44
20170604 642246 800 2017060426051,6/4/2017,6/4/2017,Debit,-8,,355111298,Withdrawal Transfer From 4076823,Transfer,Withdrawal,4485.69
20170603 642246 2500 2017060326050,6/3/2017,6/3/2017,Debit,-25,,355007544,Withdrawal Transfer From 4076823,Transfer,Withdrawal,4493.69
20170603 642246 40000 2017060326049,6/3/2017,6/3/2017,Debit,-400,,355007364,Withdrawal Transfer From 4076823 Scheduled Recurring Transfer,Transfer,Withdrawal,4518.69
20170603 642246 29800 2017060326048,6/3/2017,6/3/2017,Credit,298,,354832421,Credit BEST BUY LANDSCAPE SUP 2200 NW CORNELIUS PASS HILLSBORO    O,,,4918.69
20170603 642246 910 2017060326047,6/3/2017,6/3/2017,Debit,-9.1,,354832422,POS Transaction  AMAZON.COM             SEATTLE      WAUS,,Debit Card,4620.69
20170603 642246 1769 2017060326046,6/3/2017,6/3/2017,Debit,-17.69,,354832423,POS Transaction 1405308 QUALITY F 7525 SW BARN PORTLAND     ORUS,,Debit Card,4629.79
20170603 642246 3495 2017060326045,6/3/2017,6/3/2017,Debit,-34.95,,354832424,POS Transaction  AMAZON.COM             SEATTLE      WAUS,,Debit Card,4647.48
20170602 642246 175 2017060226044,6/2/2017,6/2/2017,Debit,-1.75,,354655208,POS Transaction OREGON PARKING PORTLAN 1225 FERRY ST SE # U   SALEM        O,,Debit Card,4682.43
20170602 642246 100 2017060226043,6/2/2017,6/2/2017,Debit,-1,,354655209,POS Transaction CITY OF PORTLAND DEPT 1120 SW 5TH AVE STE    PORTLAND     OR,,Debit Card,4684.18
20170602 642246 29800 2017060226042,6/2/2017,6/2/2017,Debit,-298,,354380139,POS Transaction BEST BUY LANDSCAPE SUP 2200 NW CORNELIUS PASS HILLSBORO    O,,Debit Card,4685.18
20170601 642246 2008 2017060126041,6/1/2017,6/1/2017,Check,-20.08,6079,354380140,Electronic Check WALGREENS PURCHASE PORT OR SERIAL #: 6079,Health & Fitness,Checks,4983.18
20170601 642246 2000 2017060126040,6/1/2017,6/1/2017,Debit,-20,,354051512,ATM Withdrawal FIRST TECH 800 NE OREGON AVE      PORTLAND     ORUS,,Debit Card,5003.26
20170601 642246 8000 2017060126039,6/1/2017,6/1/2017,Debit,-80,,354045028,Withdrawal Transfer From 4076823,Transfer,Withdrawal,5023.26
20170601 642246 2000 2017060126038,6/1/2017,6/1/2017,Debit,-20,,353989172,Withdrawal Transfer From 4076823 For a car budget,Transfer,Withdrawal,5103.26
20170601 642246 509640 2017060126037,6/1/2017,6/1/2017,Credit,5096.4,,353942156,ACH Deposit HEALTH AUTHORITY STATE OF OREGON - DIRECT DEP,,ACH,5123.26
20170601 642246 1299 2017060126036,6/1/2017,6/1/2017,Debit,-12.99,,353942158,"POS Transaction Audible US 1 Washington Park, 16th888-283-5051 NJUS",,Debit Card,26.86
20170601 642246 999 2017060126035,6/1/2017,6/1/2017,Debit,-9.99,,353942159,POS Transaction Amazon Services-Kindle 440 Terry Ave N        866-321-8851 W,Shopping,Debit Card,39.85
20170531 642246 202 2017053126034,5/31/2017,5/31/2017,Credit,2.02,,353942160,Credit Dividend,,,49.84
20170531 642246 1000 2017053126033,5/31/2017,5/31/2017,Debit,-10,,353666517,Withdrawal Transfer From 4076823,Transfer,Withdrawal,47.82
20170531 642246 75 2017053126032,5/31/2017,5/31/2017,Debit,-0.75,,353666322,POS Transaction CITY OF PORTLAND DEPT 1120 SW 5TH AVE STE    PORTLAND     OR,,Debit Card,57.82
20170531 642246 8000 2017053126031,5/31/2017,5/31/2017,Debit,-80,,353521229,Withdrawal Transfer From 4076823,Transfer,Withdrawal,58.57
20170531 642246 7000 2017053126030,5/31/2017,5/31/2017,Credit,70,,353520548,ATM Deposit FIRST TECH 800 NE OREGON AVE      PORTLAND     ORUS,,Debit Card,138.57
20170531 642246 200 2017053126029,5/31/2017,5/31/2017,Debit,-2,,353476466,POS Transaction CITY OF PORTLAND DEPT 1120 SW 5TH AVE STE    PORTLAND     OR,,Debit Card,68.57
20170531 642246 9700 2017053126028,5/31/2017,5/31/2017,Debit,-97,,353476467,POS Transaction THE HOME DEPOT #4001 13700 NS SCIENCE PARK DPORTLAND     ORU,Home,Debit Card,70.57
20170531 642246 930 2017053126027,5/31/2017,5/31/2017,Debit,-9.3,,353476468,POS Transaction CHIPOTLE 2686 13535 NW CORNELL RD    PORTLAND     ORUS,Food & Dining,Debit Card,167.57
20170531 642246 200 2017053126026,5/31/2017,5/31/2017,Debit,-2,,353476469,POS Transaction THE HOME DEPOT #4001 13700 NS SCIENCE PARK DPORTLAND     ORU,Home,Debit Card,176.87
20170531 642246 488 2017053126025,5/31/2017,5/31/2017,Debit,-4.88,,353476470,POS Transaction TACO BELL #032947 13480 NW SCIENCE PARK DPORTLAND     ORUS,Food & Dining,Debit Card,178.87
20170530 642246 30000 2017053026024,5/30/2017,5/30/2017,Credit,300,,353235268,Deposit Transfer To 4076823,Transfer,,183.75
20170530 642246 2000 2017053026023,5/30/2017,5/30/2017,Credit,20,,353234777,Deposit Transfer To 4076823,Transfer,,-116.25
20170530 642246 994 2017053026022,5/30/2017,5/30/2017,Debit,-9.94,,353232514,POS Transaction JERSEY MIKE'S 32014 13543 NW CORNELL RD    PORTLAND     ORUS,,Debit Card,-136.25
20170530 642246 2000 2017053026021,5/30/2017,5/30/2017,Debit,-20,,353232515,POS Transaction CHEVRON 0209449 12440 NW MAIN ST.      BANKS        ORUS,Auto & Transport,Debit Card,-126.31
20170530 642246 199 2017053026020,5/30/2017,5/30/2017,Debit,-1.99,,353232516,POS Transaction Amazon Services-Kindle 440 Terry Ave N        866-321-8851 W,Shopping,Debit Card,-106.31
20170530 642246 1000 2017053026019,5/30/2017,5/30/2017,Debit,-10,,353232517,POS Transaction ARCO CORNELL 06501 15320 NW CORNELL RD    BEAVERTON    ORUS,,Debit Card,-104.32
20170530 642246 6999 2017053026018,5/30/2017,5/30/2017,Debit,-69.99,,352985466,POS Transaction  AMAZON.COM             SEATTLE      WAUS,,Debit Card,-94.32
20170530 642246 2433 2017053026017,5/30/2017,5/30/2017,Debit,-24.33,,352985467,POS Transaction THE HOME DEPOT #4001 13700 NS SCIENCE PARK DPORTLAND     ORU,Home,Debit Card,-24.33
20170529 642246 19310 2017052926016,5/29/2017,5/29/2017,Credit,193.1,,352985468,Overdraft Transfer,Transfer,Transfer,0
20170529 642246 1800 2017052926015,5/29/2017,5/29/2017,Debit,-18,,352985469,POS Transaction SYKART INDOOR RACING 8205 SW HUNZIKER ST    TIGARD       ORU,,Debit Card,-193.1
20170529 642246 1800 2017052926014,5/29/2017,5/29/2017,Debit,-18,,352985470,POS Transaction SYKART INDOOR RACING 8205 SW HUNZIKER ST    TIGARD       ORU,,Debit Card,-175.1
20170529 642246 1200 2017052926013,5/29/2017,5/29/2017,Debit,-12,,352985471,POS Transaction GROUPON INC 600 W Chicago Ave      877-788-7858 ILUS,,Debit Card,-157.1
20170529 642246 4160 2017052926012,5/29/2017,5/29/2017,Debit,-41.6,,352985472,POS Transaction OBA 555 NW 12TH AVE        PORTLAND     ORUS,,Debit Card,-145.1
20170529 642246 4094 2017052926011,5/29/2017,5/29/2017,Debit,-40.94,,352985473,POS Transaction NY TIMES NATL SALES 620 Eighth Ave 22nd Fl 800-698-4637 NYUS,,Debit Card,-103.5
20170529 642246 3120 2017052926010,5/29/2017,5/29/2017,Debit,-31.2,,352985474,POS Transaction EMERSON HARDWOOD   CCP 3065 NW FRONT AVE      PORTLAND     O,,Debit Card,-62.56
20170529 642246 199 2017052926009,5/29/2017,5/29/2017,Debit,-1.99,,352985475,POS Transaction GOOGLE *Google Storage 1600 Amphitheatre Pkwy 855-492-5538 C,Entertainment,Debit Card,-31.36
20170529 642246 1898 2017052926008,5/29/2017,5/29/2017,Debit,-18.98,,352985476,POS Transaction BEST BUY LANDSCAPE SUP 2200 NW CORNELIUS PASS HILLSBORO    O,,Debit Card,-29.37
20170529 642246 3996 2017052926007,5/29/2017,5/29/2017,Debit,-39.96,,352985477,POS Transaction ORCHARD SUPPLY #761 10860 SW BARNES RD     PORTLAND     ORUS,,Debit Card,-10.39
20170529 642246 3487 2017052926006,5/29/2017,5/29/2017,Debit,-34.87,,352985478,POS Transaction ORCHARD SUPPLY #761 10860 SW BARNES RD     PORTLAND     ORUS,,Debit Card,29.57
20170529 642246 8703 2017052926005,5/29/2017,5/29/2017,Debit,-87.03,,352985479,POS Transaction BEST BUY LANDSCAPE SUP 2200 NW CORNELIUS PASS HILLSBORO    O,,Debit Card,64.44
20170529 642246 1096 2017052926004,5/29/2017,5/29/2017,Debit,-10.96,,352743480,POS Transaction ORCHARD SUPPLY #761 10860 SW BARNES RD     PORTLAND     ORUS,,Debit Card,151.47
20170528 642246 5272 2017052826003,5/28/2017,5/28/2017,Debit,-52.72,,352743481,POS Transaction THE HOME DEPOT #4001 13700 NS SCIENCE PARK DPORTLAND     ORU,Home,Debit Card,162.43
20170528 642246 3999 2017052826002,5/28/2017,5/28/2017,Debit,-39.99,,352743482,POS Transaction  AMAZON.COM             SEATTLE      WAUS,,Debit Card,215.15
20170528 642246 2100 2017052826001,5/28/2017,5/28/2017,Debit,-21,,352743483,POS Transaction  AMAZON.COM             SEATTLE      WAUS,,Debit Card,255.14
20170528 642246 800 2017052826000,5/28/2017,5/28/2017,Debit,-8,,352646061,Withdrawal Transfer From 4076823,Transfer,Withdrawal,276.14
20170528 642246 988 2017052825999,5/28/2017,5/28/2017,Debit,-9.88,,352646062,POS Transaction ARCO CORNELL 06501 15320 NW CORNELL RD    BEAVERTON    ORUS,,Debit Card,284.14
20170528 642246 4740 2017052825998,5/28/2017,5/28/2017,Debit,-47.4,,352646063,POS Transaction ARCO CORNELL 06501 15320 NW CORNELL RD    BEAVERTON    ORUS,,Debit Card,294.02
20170527 642246 1798 2017052725997,5/27/2017,5/27/2017,Debit,-17.98,,352589025,POS Transaction CORNELL FARM 8212 SW BARNES ROA     PORTLAND     ORUS,,Debit Card,341.42
20170527 642246 6008 2017052725996,5/27/2017,5/27/2017,Debit,-60.08,,352589026,POS Transaction FARMINGTON GARDENS 26985 S.W. FARMING     HILLSBORO    ORUS,,Debit Card,359.4
20170527 642246 5600 2017052725995,5/27/2017,5/27/2017,Debit,-56,,352589027,POS Transaction GROUPON INC 600 W Chicago Ave      877-788-7858 ILUS,,Debit Card,419.48
20170527 642246 19044 2017052725994,5/27/2017,5/27/2017,Debit,-190.44,,352589028,POS Transaction 9115596 WINCO FOO 7330 Nw Butl Hillsboro    ORUS,,Debit Card,475.48
20170527 642246 700 2017052725993,5/27/2017,5/27/2017,Debit,-7,,352434067,POS Transaction BUFFALO WILD WINGS 349 11995 SW BEAVERTON HILLBEAVERTON    O,,Debit Card,665.92
20170527 642246 10000 2017052725992,5/27/2017,5/27/2017,Debit,-100,,352434068,POS Transaction THE HOME DEPOT #4001 13700 NS SCIENCE PARK DPORTLAND     ORU,Home,Debit Card,672.92
20170527 642246 7800 2017052725991,5/27/2017,5/27/2017,Debit,-78,,352434069,POS Transaction BEST BUY LANDSCAPE SUP 2200 NW CORNELIUS PASS HILLSBORO    O,,Debit Card,772.92
20170527 642246 4060 2017052725990,5/27/2017,5/27/2017,Credit,40.6,,352434070,Credit THE HOME DEPOT #4001 13700 NS SCIENCE PARK DPORTLAND     ORU,Home,,850.92
20170527 642246 932 2017052725989,5/27/2017,5/27/2017,Debit,-9.32,,352434071,POS Transaction QUALITY FOOD CEN 7525 SW BARNES RD      PORTLAND     ORUS,,Debit Card,810.32
20170526 642246 29288 2017052625988,5/26/2017,5/26/2017,Debit,-292.88,,352434072,ACH Debit BKAMERICA  - IC PAYMENT,,ACH,819.64
20170526 642246 300 2017052625987,5/26/2017,5/26/2017,Debit,-3,,352434073,POS Transaction DOLLAR TREE 17475 SW FARMINGTON RD ALOHA        ORUS,,Debit Card,1112.52
20170526 642246 3100 2017052625986,5/26/2017,5/26/2017,Debit,-31,,352257765,Withdrawal Transfer From 4076823,Transfer,Withdrawal,1115.52
20170526 642246 249 2017052625985,5/26/2017,5/26/2017,Debit,-2.49,,352257635,POS Transaction 44647 JIM'S SUP 660 S MAIN S BANKS        ORUS,,Debit Card,1146.52
20170526 642246 2259 2017052625984,5/26/2017,5/26/2017,Debit,-22.59,,352257636,POS Transaction  AMAZON.COM             SEATTLE      WAUS,,Debit Card,1149.01
20170526 642246 2360 2017052625983,5/26/2017,5/26/2017,Debit,-23.6,,352257637,POS Transaction CHIPOTLE 2686 13535 NW CORNELL RD    PORTLAND     ORUS,Food & Dining,Debit Card,1171.6
20170526 642246 199 2017052625982,5/26/2017,5/26/2017,Debit,-1.99,,352257638,"POS Transaction Audible US 1 Washington Park, 16th888-283-5051 NJUS",,Debit Card,1195.2
20170526 642246 1932 2017052625981,5/26/2017,5/26/2017,Debit,-19.32,,352062657,POS Transaction 1405308 QUALITY F 7525 SW BARN PORTLAND     ORUS,,Debit Card,1197.19
20170526 642246 630 2017052625980,5/26/2017,5/26/2017,Debit,-6.3,,352062658,POS Transaction 6710700379 THE HOME DEPOT #4001   PORTLAND     ORUS,Home,Debit Card,1216.51
20170525 642246 6895 2017052525979,5/25/2017,5/25/2017,Debit,-68.95,,352062659,POS Transaction 573758 HOMEGOODS 11959 SW CAN BEAVERTON    ORUS,,Debit Card,1222.81
20170525 642246 649 2017052525978,5/25/2017,5/25/2017,Debit,-6.49,,352062660,POS Transaction  CHEVRON/CSI-094033/1189PORTLAND     ORUS,,Debit Card,1291.76
20170525 642246 1698 2017052525977,5/25/2017,5/25/2017,Debit,-16.98,,352062661,POS Transaction PRECISION OUTDOOR POWER 10705 RED RUN BLVD     BANKS,,Debit Card,1298.25
20170525 642246 6240 2017052525976,5/25/2017,5/25/2017,Debit,-62.4,,352062662,POS Transaction EMERSON HARDWOOD   CCP 3065 NW FRONT AVE      PORTLAND     O,,Debit Card,1315.23
20170525 642246 567 2017052525975,5/25/2017,5/25/2017,Debit,-5.67,,351840583,POS Transaction 44647 JIM'S SUP 660 S MAIN S BANKS        ORUS,,Debit Card,1377.63
20170525 642246 11287 2017052525974,5/25/2017,5/25/2017,Debit,-112.87,,351840584,POS Transaction FARMINGTON GARDENS 26985 S.W. FARMING     HILLSBORO    ORUS,,Debit Card,1383.3
20170525 642246 30000 2017052525973,5/25/2017,5/25/2017,Debit,-300,,351840585,Withdrawal Transfer From 4076823 Vacation #CT,Transfer,Withdrawal,1496.17
20170525 642246 770 2017052525972,5/25/2017,5/25/2017,Debit,-7.7,,351840586,POS Transaction CHIPOTLE 2686 13535 NW CORNELL RD    PORTLAND     ORUS,Food & Dining,Debit Card,1796.17
20170525 642246 5409 2017052525971,5/25/2017,5/25/2017,Debit,-54.09,,351840587,POS Transaction SHELL OIL 574431442QPS 12805 NW CORNELL RD    PORTLAND     O,Auto & Transport,Debit Card,1803.87
20170525 642246 1746 2017052525970,5/25/2017,5/25/2017,Debit,-17.46,,351840588,POS Transaction 694141 TRADER JOE'S #         BEAVERTON    ORUS,,Debit Card,1857.96
20170525 642246 999 2017052525968,5/25/2017,5/25/2017,Debit,-9.99,,351840590,POS Transaction  NETFLIX COM            LOS GATOS    CAUS,,Debit Card,1937.42
20170524 642246 6200 2017052425969,5/24/2017,5/24/2017,Check,-62,6077,351840589,Check #6077,,Checks,1875.42
20170524 642246 1000 2017052425967,5/24/2017,5/24/2017,Debit,-10,,351529600,Withdrawal Transfer From 4076823,Transfer,Withdrawal,1947.41
20170524 642246 1000 2017052425966,5/24/2017,5/24/2017,Debit,-10,,351529424,POS Transaction UDEMY.COM 360 3RD ST # 400       8888385432   CAUS,,Debit Card,1957.41
20170524 642246 5490 2017052425965,5/24/2017,5/24/2017,Debit,-54.9,,351529425,POS Transaction IMATHLETE.COM 2800 28th Street       877-4627979  CAUS,,Debit Card,1967.41
20170524 642246 5490 2017052425964,5/24/2017,5/24/2017,Debit,-54.9,,351529426,POS Transaction IMATHLETE.COM 2800 28th Street       877-4627979  CAUS,,Debit Card,2022.31
20170524 642246 1000 2017052425963,5/24/2017,5/24/2017,Debit,-10,,351468543,POS Transaction SHELL OIL 574431442QPS 12805 NW CORNELL RD    PORTLAND     O,Auto & Transport,Debit Card,2077.21
20170524 642246 1985 2017052425962,5/24/2017,5/24/2017,Debit,-19.85,,351468544,POS Transaction  AMAZON.COM             SEATTLE      WAUS,,Debit Card,2087.21
20170524 642246 1017 2017052425961,5/24/2017,5/24/2017,Debit,-10.17,,351468545,POS Transaction QUALITY FOOD CEN 7525 SW BARNES RD      PORTLAND     ORUS,,Debit Card,2107.06
20170523 642246 13391 2017052325960,5/23/2017,5/23/2017,Debit,-133.91,,351468546,ACH Debit FEDLOANSERVICING ACH TRANSACTION - STDNT LOAN,,ACH,2117.23
20170523 642246 12015 2017052325959,5/23/2017,5/23/2017,Debit,-120.15,,351468547,ACH Debit USAA.COM PAY EXT ACH PAYMENTS - LIFE,,ACH,2251.14
20170523 642246 500 2017052325958,5/23/2017,5/23/2017,Debit,-5,,351468548,ACH Debit OPB  - DONATION,,ACH,2371.29
20170523 642246 799 2017052325957,5/23/2017,5/23/2017,Debit,-7.99,,351283313,POS Transaction  AMAZON.COM             SEATTLE      WAUS,,Debit Card,2376.29
20170523 642246 700 2017052325956,5/23/2017,5/23/2017,Debit,-7,,351283314,POS Transaction CTY CTR PARKNG 061018 600 NE GRAND AVE       PORTLAND     OR,,Debit Card,2384.28
20170523 642246 199 2017052325955,5/23/2017,5/23/2017,Debit,-1.99,,351283315,POS Transaction Amazon Services-Kindle 440 Terry Ave N        866-321-8851 W,Shopping,Debit Card,2391.28
20170523 642246 3000 2017052325954,5/23/2017,5/23/2017,Debit,-30,,351283316,POS Transaction HAIRM 3300 SW HOCKEN AVE     BEAVERTON    ORUS,,Debit Card,2393.27
20170523 642246 16500 2017052325953,5/23/2017,5/23/2017,Debit,-165,,351283317,POS Transaction BLUESOMBRERO6:SPORT RE 112 KROG STREET NE #10 08669812583  G,,Debit Card,2423.27
20170523 642246 399 2017052325952,5/23/2017,5/23/2017,Debit,-3.99,,351283318,POS Transaction QUALITY FOOD CEN 7525 SW BARNES RD      PORTLAND     ORUS,,Debit Card,2588.27
20170522 642246 3000 2017052225951,5/22/2017,5/22/2017,Debit,-30,,351283319,POS Transaction VIVID EYE CARE 6506 NE CAMPUS WAY     HILLSBORO    ORUS,,Debit Card,2592.26
20170522 642246 12392 2017052225950,5/22/2017,5/22/2017,Debit,-123.92,,351283320,POS Transaction FARMINGTON GARDENS 26985 S.W. FARMING     HILLSBORO    ORUS,,Debit Card,2622.26
20170522 642246 13801 2017052225949,5/22/2017,5/22/2017,Debit,-138.01,,351283321,POS Transaction S AND H LOGGING INC 20200 SW STAFFORD RD   TUALATIN     ORUS,,Debit Card,2746.18
20170522 642246 1496 2017052225948,5/22/2017,5/22/2017,Debit,-14.96,,350881393,POS Transaction KITCHEN KABOODLE-ORENC 1415 NE 61ST AVE       HILLSBORO    O,,Debit Card,2884.19
20170522 642246 5000 2017052225947,5/22/2017,5/22/2017,Debit,-50,,350881394,POS Transaction THE HOME DEPOT #4001 13700 NS SCIENCE PARK DPORTLAND     ORU,Home,Debit Card,2899.15
20170522 642246 170 2017052225946,5/22/2017,5/22/2017,Debit,-1.7,,350881395,POS Transaction THE HOME DEPOT #4001 13700 NS SCIENCE PARK DPORTLAND     ORU,Home,Debit Card,2949.15
20170522 642246 400 2017052225945,5/22/2017,5/22/2017,Credit,4,,350881396,Credit THE HOME DEPOT #4001 13700 NS SCIENCE PARK DPORTLAND     ORU,Home,,2950.85
20170522 642246 800 2017052225944,5/22/2017,5/22/2017,Debit,-8,,350881397,POS Transaction SQU*SQ *KAADY CAR WASH 2170 Northeast Cornell Hillsboro    O,,Debit Card,2946.85
20170522 642246 5000 2017052225943,5/22/2017,5/22/2017,Debit,-50,,350881398,POS Transaction THE HOME DEPOT #4001 13700 NS SCIENCE PARK DPORTLAND     ORU,Home,Debit Card,2954.85
20170522 642246 10043 2017052225942,5/22/2017,5/22/2017,Debit,-100.43,,350805717,POS Transaction  AMAZON.COM             SEATTLE      WAUS,,Debit Card,3004.85
20170522 642246 4200 2017052225941,5/22/2017,5/22/2017,Debit,-42,,350805718,POS Transaction ROCK CREEK TAVERN 10000 NW Old Cornelius HILLSBORO    ORUS,,Debit Card,3105.28
20170522 642246 1000 2017052225940,5/22/2017,5/22/2017,Debit,-10,,350805719,POS Transaction SHELL OIL 574431442QPS 12805 NW CORNELL RD    PORTLAND     O,Auto & Transport,Debit Card,3147.28
20170522 642246 900 2017052225939,5/22/2017,5/22/2017,Debit,-9,,350805720,Withdrawal Transfer From 4076823 9,Transfer,Withdrawal,3157.28
20170522 642246 33500 2017052225938,5/22/2017,5/22/2017,Debit,-335,,350805721,Withdrawal Transfer From 4076823,Transfer,Withdrawal,3166.28
20170522 642246 5000 2017052225937,5/22/2017,5/22/2017,Debit,-50,,350805722,Withdrawal Transfer From 4076823,Transfer,Withdrawal,3501.28
20170522 642246 40000 2017052225936,5/22/2017,5/22/2017,Debit,-400,,350805723,Withdrawal Transfer From 4076823,Transfer,Withdrawal,3551.28
20170522 642246 5000 2017052225935,5/22/2017,5/22/2017,Debit,-50,,350805724,Withdrawal Transfer From 4076823,Transfer,Withdrawal,3951.28
20170522 642246 35000 2017052225934,5/22/2017,5/22/2017,Debit,-350,,350805725,Withdrawal Transfer From 4076823 Pay off this SOB!,Transfer,Withdrawal,4001.28
20170522 642246 2517 2017052225933,5/22/2017,5/22/2017,Debit,-25.17,,350744949,POS Transaction ORCHARD SUPPLY #761 10860 SW BARNES RD     PORTLAND     ORUS,,Debit Card,4351.28
20170521 642246 278 2017052125932,5/21/2017,5/21/2017,Debit,-2.78,,350744950,POS Transaction SHELL Service Station 12805 NW CORNELL ROAD  PORTLAND     OR,Auto & Transport,Debit Card,4376.45
20170521 642246 1184 2017052125931,5/21/2017,5/21/2017,Debit,-11.84,,350744951,POS Transaction 6710700379 THE HOME DEPOT #4001   PORTLAND     ORUS,Home,Debit Card,4379.23
20170521 642246 800 2017052125930,5/21/2017,5/21/2017,Debit,-8,,350744952,Withdrawal Transfer From 4076823,Transfer,Withdrawal,4391.07
20170521 642246 1178 2017052125929,5/21/2017,5/21/2017,Debit,-11.78,,350616000,POS Transaction  CHEVRON/CSI-094033/1189PORTLAND     ORUS,,Debit Card,4399.07
20170521 642246 4495 2017052125928,5/21/2017,5/21/2017,Debit,-44.95,,350616001,POS Transaction ARCO CORNELL 06501 15320 NW CORNELL RD    BEAVERTON    ORUS,,Debit Card,4410.85
20170521 642246 1326 2017052125927,5/21/2017,5/21/2017,Debit,-13.26,,350616002,POS Transaction 6710700379 THE HOME DEPOT #4001   PORTLAND     ORUS,Home,Debit Card,4455.8
20170520 642246 14158 2017052025926,5/20/2017,5/20/2017,Debit,-141.58,,350508840,POS Transaction 9115596 WINCO FOO 7330 Nw Butl Hillsboro    ORUS,,Debit Card,4469.06
20170520 642246 1000 2017052025925,5/20/2017,5/20/2017,Debit,-10,,350487716,Withdrawal Transfer From 4076823,Transfer,Withdrawal,4610.64
20170520 642246 474 2017052025924,5/20/2017,5/20/2017,Debit,-4.74,,350487660,POS Transaction NEW SEASON MARKET -#3 1453 NE 61ST AVE       HILLSBORO    OR,,Debit Card,4620.64
20170520 642246 8667 2017052025923,5/20/2017,5/20/2017,Debit,-86.67,,350487661,POS Transaction THE HOME DEPOT #4001 13700 NS SCIENCE PARK DPORTLAND     ORU,Home,Debit Card,4625.38
20170520 642246 600 2017052025922,5/20/2017,5/20/2017,Debit,-6,,350487662,POS Transaction 22732163899 CEDAR MILL LUMBER & HA PORTLAND     ORUS,,Debit Card,4712.05
20170520 642246 2499 2017052025921,5/20/2017,5/20/2017,Credit,24.99,,350362718,Credit GROUPON INC 600 W Chicago Ave      877-788-7858 ILUS,,,4718.05
20170520 642246 2499 2017052025920,5/20/2017,5/20/2017,Debit,-24.99,,350362719,POS Transaction GROUPON INC 600 W Chicago Ave      877-788-7858 ILUS,,Debit Card,4693.06
20170520 642246 500 2017052025919,5/20/2017,5/20/2017,Debit,-5,,350317913,Withdrawal Transfer From 4076823,Transfer,Withdrawal,4718.05
20170520 642246 1195 2017052025918,5/20/2017,5/20/2017,Debit,-11.95,,350317786,POS Transaction 2450001525 SAFEWAY  STORE  1525   PORTLAND     ORUS,,Debit Card,4723.05
20170520 642246 1099 2017052025917,5/20/2017,5/20/2017,Debit,-10.99,,350317787,POS Transaction SHELL Service Station 12805 NW CORNELL ROAD  PORTLAND     OR,Auto & Transport,Debit Card,4735
20170520 642246 179 2017052025916,5/20/2017,5/20/2017,Debit,-1.79,,350317788,POS Transaction QUALITY FOOD CEN 7525 SW BARNES RD      PORTLAND     ORUS,,Debit Card,4745.99
20170519 642246 599 2017051925915,5/19/2017,5/19/2017,Debit,-5.99,,350317789,POS Transaction 2450001612 SAFEWAY  STORE  1612   PORTLAND     ORUS,,Debit Card,4747.78
20170519 642246 125 2017051925914,5/19/2017,5/19/2017,Debit,-1.25,,350083060,POS Transaction CITY OF PORTLAND DEPT 1120 SW 5TH AVE STE    PORTLAND     OR,,Debit Card,4753.77
20170519 642246 200 2017051925913,5/19/2017,5/19/2017,Debit,-2,,350083061,POS Transaction CITY OF PORTLAND DEPT 1120 SW 5TH AVE STE    PORTLAND     OR,,Debit Card,4755.02
20170519 642246 1125 2017051925912,5/19/2017,5/19/2017,Debit,-11.25,,350083062,POS Transaction BEN AND JERRY'S # 39 NW 23 PLACE         PORTLAND     ORUS,,Debit Card,4757.02
20170519 642246 1400 2017051925911,5/19/2017,5/19/2017,Debit,-14,,350083063,POS Transaction THE 1905 830 N SHAVER ST        PORTLAND     ORUS,,Debit Card,4768.27
20170519 642246 475631 2017051925910,5/19/2017,5/19/2017,Credit,4756.31,,350083064,ACH Deposit BEAVERTON SCHOOL PAYROLL 1701005 - PAYROLL,,ACH,4782.27
20170519 642246 693 2017051925909,5/19/2017,5/19/2017,Debit,-6.93,,350083065,POS Transaction NEW SEASONS MARKET # 16 2170 NW RALEIGH STREET PORTLAND,,Debit Card,25.96
20170519 642246 4549 2017051925908,5/19/2017,5/19/2017,Credit,45.49,,349938570,Credit AMAZON.COM REFUNDAMAZON.COM       SEATTLE      WAUS,,,32.89
20170519 642246 1260 2017051925907,5/19/2017,5/19/2017,Debit,-12.6,,349938571,POS Transaction QUALITY FOOD CEN 7525 SW BARNES RD      PORTLAND     ORUS,,Debit Card,-12.6
20170518 642246 27329 2017051825906,5/18/2017,5/18/2017,Credit,273.29,,349938572,Overdraft Transfer,Transfer,Transfer,0
20170518 642246 679 2017051825905,5/18/2017,5/18/2017,Debit,-6.79,,349938573,POS Transaction QUALITY FOOD CEN 7525 SW BARNES RD      PORTLAND     ORUS,,Debit Card,-273.29
20170518 642246 225 2017051825904,5/18/2017,5/18/2017,Debit,-2.25,,349801226,POS Transaction OREGON PARKING PORTLAN 1225 FERRY ST SE # U   SALEM        O,,Debit Card,-266.5
20170518 642246 225 2017051825903,5/18/2017,5/18/2017,Debit,-2.25,,349801227,POS Transaction OREGON PARKING PORTLAN 1225 FERRY ST SE # U   SALEM        O,,Debit Card,-264.25
20170518 642246 6972 2017051825902,5/18/2017,5/18/2017,Debit,-69.72,,349801228,POS Transaction W L MAY CO 835 E BURNSIDE ST      PORTLAND     ORUS,,Debit Card,-262
20170518 642246 511 2017051825900,5/18/2017,5/18/2017,Debit,-5.11,,349741003,POS Transaction QUALITY FOOD CEN 7525 SW BARNES RD      PORTLAND     ORUS,,Debit Card,-180.28
20170517 642246 1200 2017051725901,5/17/2017,5/17/2017,Check,-12,6076,349741002,Check #6076,,Checks,-192.28
20170517 642246 17517 2017051725899,5/17/2017,5/17/2017,Debit,-175.17,,349468641,ACH Debit TUALATIN VALLEY FIRST TECH FCU B - BILL PAYMT,,ACH,-175.17
20170517 642246 20270 2017051725898,5/17/2017,5/17/2017,Credit,202.7,,349468642,Overdraft Transfer,Transfer,Transfer,0
20170517 642246 225 2017051725897,5/17/2017,5/17/2017,Debit,-2.25,,349468643,POS Transaction OREGON PARKING PORTLAN 1225 FERRY ST SE # U   SALEM        O,,Debit Card,-202.7
20170517 642246 225 2017051725896,5/17/2017,5/17/2017,Debit,-2.25,,349468644,POS Transaction OREGON PARKING PORTLAN 1225 FERRY ST SE # U   SALEM        O,,Debit Card,-200.45
20170516 642246 3500 2017051625895,5/16/2017,5/16/2017,Check,-35,6074,349468645,Check #6074,,Checks,-198.2
20170516 642246 16320 2017051625894,5/16/2017,5/16/2017,Debit,-163.2,,349468646,ACH Debit PROG UNIVERSAL BRANCH16DEBIT  ACH - INS PREM,,ACH,-163.2
20170516 642246 13964 2017051625893,5/16/2017,5/16/2017,Credit,139.64,,349468647,Overdraft Transfer,Transfer,Transfer,0
20170516 642246 225 2017051625892,5/16/2017,5/16/2017,Debit,-2.25,,349468648,POS Transaction OREGON PARKING PORTLAN 1225 FERRY ST SE # U   SALEM        O,,Debit Card,-139.64
20170516 642246 11100 2017051625891,5/16/2017,5/16/2017,Debit,-111,,349468649,POS Transaction BANK OF AMERICA NA 1100 N KING ST         08777335734  DEUS,,Debit Card,-137.39
20170516 642246 1430 2017051625890,5/16/2017,5/16/2017,Debit,-14.3,,349468650,POS Transaction CAMBRIDGE FINE CLE 11130 SW Barnes Rd     503-643-7217 ORUS,,Debit Card,-26.39
20170516 642246 219 2017051625889,5/16/2017,5/16/2017,Debit,-2.19,,349468651,POS Transaction ORCHARD SUPPLY #761 10860 SW BARNES RD     PORTLAND     ORUS,,Debit Card,-12.09
20170516 642246 199 2017051625888,5/16/2017,5/16/2017,Debit,-1.99,,349468652,POS Transaction 40785 BALES CED 1881 SW NAIT PORTLAND     ORUS,,Debit Card,-9.9
20170516 642246 4000 2017051625887,5/16/2017,5/16/2017,Debit,-40,,348754376,POS Transaction ARCO CORNELL 06501 15320 NW CORNELL RD    BEAVERTON    ORUS,,Debit Card,-7.91
20170515 642246 1033 2017051525886,5/15/2017,5/15/2017,Debit,-10.33,,348754377,ACH Debit SAFECO INSURANCE  - INS PREM,,ACH,32.09
20170515 642246 1700 2017051525885,5/15/2017,5/15/2017,Debit,-17,,348754378,POS Transaction SQU*SQ *UPSTREAM COFFE 315 SW Montgomery StrePortland     OR,,Debit Card,42.42
20170515 642246 780 2017051525884,5/15/2017,5/15/2017,Debit,-7.8,,348754379,POS Transaction 2450001525 SAFEWAY  STORE  1525   PORTLAND     ORUS,,Debit Card,59.42
20170515 642246 3700 2017051525883,5/15/2017,5/15/2017,Debit,-37,,348754380,POS Transaction METRO CENTRAL SW DISPO 6161 NW 61ST AVE       PORTLAND     O,,Debit Card,67.22
20170515 642246 4426 2017051525882,5/15/2017,5/15/2017,Debit,-44.26,,348754381,POS Transaction FRED M FUEL #9661 Q76 22075 NW IMBRIE DR     HILLSBORO    OR,,Debit Card,104.22
20170515 642246 2992 2017051525881,5/15/2017,5/15/2017,Debit,-29.92,,348754382,POS Transaction MERIWETHERS 2601 NW VAUGHN ST      PORTLAND     ORUS,,Debit Card,148.48
20170515 642246 900 2017051525880,5/15/2017,5/15/2017,Debit,-9,,348754383,Withdrawal Transfer From 4076823 9,Transfer,Withdrawal,178.4
20170515 642246 1260 2017051525879,5/15/2017,5/15/2017,Debit,-12.6,,348754384,POS Transaction QUALITY FOOD CEN 7525 SW BARNES RD      PORTLAND     ORUS,,Debit Card,187.4
20170514 642246 20000 2017051425878,5/14/2017,5/14/2017,Credit,200,,348372744,Deposit Transfer To 4076823,Transfer,,200
20170514 642246 4999 2017051425877,5/14/2017,5/14/2017,Credit,49.99,,348372693,Overdraft Transfer,Transfer,Transfer,0
20170514 642246 4999 2017051425876,5/14/2017,5/14/2017,Debit,-49.99,,348322752,POS Transaction LAMPS PLUS - 41 8748 SW HALL BLVD      BEAVERTON    ORUS,,Debit Card,-49.99
20170513 642246 38928 2017051325875,5/13/2017,5/13/2017,Credit,389.28,,348322753,Overdraft Transfer,Transfer,Transfer,0
20170513 642246 2295 2017051325874,5/13/2017,5/13/2017,Debit,-22.95,,348322754,POS Transaction 1783 U-HAUL MO 14225 SW TUA BEAVERTON    ORUS,,Debit Card,-389.28
20170513 642246 2999 2017051325873,5/13/2017,5/13/2017,Credit,29.99,,348322755,Credit 22835116 HOMEGOODS 7650 NE BUTL HILLSBORO    ORUS,,,-366.33
20170513 642246 17192 2017051325872,5/13/2017,5/13/2017,Debit,-171.92,,348322756,POS Transaction 9115596 WINCO FOO 7330 Nw Butl Hillsboro    ORUS,,Debit Card,-396.32
20170513 642246 599 2017051325871,5/13/2017,5/13/2017,Debit,-5.99,,348322757,POS Transaction ORCHARD SUPPLY #761 10860 SW BARNES RD     PORTLAND     ORUS,,Debit Card,-224.4
20170513 642246 972 2017051325870,5/13/2017,5/13/2017,Debit,-9.72,,348322758,POS Transaction NEW SEASON MARKET -#3 1453 NE 61ST AVE       HILLSBORO    OR,,Debit Card,-218.41
20170513 642246 125 2017051325869,5/13/2017,5/13/2017,Debit,-1.25,,348322759,POS Transaction OREGON PARKING PORTLAN 1225 FERRY ST SE # U   SALEM        O,,Debit Card,-208.69
20170513 642246 300 2017051325868,5/13/2017,5/13/2017,Debit,-3,,348322760,POS Transaction CST INTOXALOCK 11035 AURORA AVE       URBANDALE    IAUS,,Debit Card,-207.44
20170513 642246 1650 2017051325867,5/13/2017,5/13/2017,Debit,-16.5,,348322761,POS Transaction GILGIMESH BREWING 2065 MADRONA AVE       97302        ORUS,,Debit Card,-204.44
20170513 642246 599 2017051325866,5/13/2017,5/13/2017,Debit,-5.99,,348322762,POS Transaction Amazon Video On Demand 440 Terry Ave N        AMZN.COM/billW,Shopping,Debit Card,-187.94
20170513 642246 199 2017051325865,5/13/2017,5/13/2017,Debit,-1.99,,348322763,POS Transaction AMAZON SERVICES-KINDLE 440 TERRY AVE N        866-216-1072 W,Shopping,Debit Card,-181.95
20170513 642246 269 2017051325864,5/13/2017,5/13/2017,Debit,-2.69,,348322764,POS Transaction QUALITY FOOD CEN 7525 SW BARNES RD      PORTLAND     ORUS,,Debit Card,-179.96
20170513 642246 2128 2017051325861,5/13/2017,5/13/2017,Debit,-21.28,,348322767,POS Transaction 1405308 QUALITY F 7525 SW BARN PORTLAND     ORUS,,Debit Card,-24.27
20170513 642246 299 2017051325860,5/13/2017,5/13/2017,Debit,-2.99,,348322768,POS Transaction ORCHARD SUPPLY #761 10860 SW BARNES RD     PORTLAND     ORUS,,Debit Card,-2.99
20170512 642246 14500 2017051225863,5/12/2017,5/12/2017,Check,-145,6069,348322765,Check #6069,,Checks,-177.27
20170512 642246 800 2017051225862,5/12/2017,5/12/2017,Check,-8,6075,348322766,Check #6075,,Checks,-32.27
20170512 642246 5083 2017051225859,5/12/2017,5/12/2017,Credit,50.83,,348322769,Overdraft Transfer,Transfer,Transfer,0
20170512 642246 225 2017051225858,5/12/2017,5/12/2017,Debit,-2.25,,348322770,POS Transaction OREGON PARKING PORTLAN 1225 FERRY ST SE # U   SALEM        O,,Debit Card,-50.83
20170512 642246 125 2017051225857,5/12/2017,5/12/2017,Debit,-1.25,,348322771,POS Transaction OREGON PARKING PORTLAN 1225 FERRY ST SE # U   SALEM        O,,Debit Card,-48.58
20170512 642246 386 2017051225856,5/12/2017,5/12/2017,Debit,-3.86,,348322772,POS Transaction QUALITY FOOD CEN 7525 SW BARNES RD      PORTLAND     ORUS,,Debit Card,-47.33
20170512 642246 4347 2017051225855,5/12/2017,5/12/2017,Debit,-43.47,,348322773,POS Transaction 100044958 WALGREENS 2103 W BURNS PORTLAND     ORUS,Health & Fitness,Debit Card,-43.47
20170511 642246 21898 2017051125854,5/11/2017,5/11/2017,Credit,218.98,,348322774,Overdraft Transfer,Transfer,Transfer,0
20170511 642246 6543 2017051125853,5/11/2017,5/11/2017,Debit,-65.43,,348322775,POS Transaction  AMAZON.COM             SEATTLE      WAUS,,Debit Card,-218.98
20170511 642246 2898 2017051125852,5/11/2017,5/11/2017,Debit,-28.98,,348322776,POS Transaction  AMAZON.COM             SEATTLE      WAUS,,Debit Card,-153.55
20170511 642246 2261 2017051125851,5/11/2017,5/11/2017,Debit,-22.61,,348322777,POS Transaction JO-ANN STORE #2101 7270 NE BUTLER ST      HILLSBORO    ORUS,Shopping,Debit Card,-124.57
20170511 642246 1299 2017051125850,5/11/2017,5/11/2017,Debit,-12.99,,348322778,"POS Transaction Audible US 1 Washington Park, 16th888-283-5051 NJUS",,Debit Card,-101.96
20170511 642246 494 2017051125849,5/11/2017,5/11/2017,Debit,-4.94,,348322779,POS Transaction QUALITY FOOD CEN 7525 SW BARNES RD      PORTLAND     ORUS,,Debit Card,-88.97
20170511 642246 100 2017051125848,5/11/2017,5/11/2017,Debit,-1,,348322780,POS Transaction THE HOME DEPOT #4001 13700 NS SCIENCE PARK DPORTLAND     ORU,Home,Debit Card,-84.03
20170511 642246 5840 2017051125847,5/11/2017,5/11/2017,Debit,-58.4,,348322781,POS Transaction THE HOME DEPOT #4001 13700 NS SCIENCE PARK DPORTLAND     ORU,Home,Debit Card,-83.03
20170511 642246 975 2017051125846,5/11/2017,5/11/2017,Debit,-9.75,,348322782,POS Transaction CAFE YUMM 100018 2755 COMMERCIAL ST SE10SALEM        ORUS,,Debit Card,-24.63
20170511 642246 699 2017051125845,5/11/2017,5/11/2017,Debit,-6.99,,348322783,POS Transaction AMAZON SERVICES-KINDLE 440 TERRY AVE N        866-216-1072 W,Shopping,Debit Card,-14.88
20170511 642246 789 2017051125844,5/11/2017,5/11/2017,Debit,-7.89,,348322784,POS Transaction QUALITY FOOD CEN 7525 SW BARNES RD      PORTLAND     ORUS,,Debit Card,-7.89
20170510 642246 52711 2017051025843,5/10/2017,5/10/2017,Credit,527.11,,348322785,Overdraft Transfer,Transfer,Transfer,0
20170510 642246 4095 2017051025842,5/10/2017,5/10/2017,Debit,-40.95,,348322786,POS Transaction 720000387154 GAP US 2810 19346 NW E HILLSBORO    ORUS,Shopping,Debit Card,-527.11
20170510 642246 3395 2017051025841,5/10/2017,5/10/2017,Credit,33.95,,348322787,Credit 222220262437 REI #89 HILLSBORO 2235 HILLSBORO    ORUS,,,-486.16
20170510 642246 7198 2017051025840,5/10/2017,5/10/2017,Debit,-71.98,,348322788,POS Transaction  AMAZON.COM             SEATTLE      WAUS,,Debit Card,-520.11
20170510 642246 1998 2017051025839,5/10/2017,5/10/2017,Debit,-19.98,,348322789,POS Transaction 22835116 HOMEGOODS 7650 NE BUTL HILLSBORO    ORUS,,Debit Card,-448.13
20170510 642246 6059 2017051025838,5/10/2017,5/10/2017,Debit,-60.59,,348322790,POS Transaction 9115596 WINCO FOO 7330 Nw Butl Hillsboro    ORUS,,Debit Card,-428.15
20170510 642246 25000 2017051025837,5/10/2017,5/10/2017,Debit,-250,,348322791,POS Transaction WORLD OF SPEED MUSEUM 27490 SW 95TH AVE      503-496-7051 OR,,Debit Card,-367.56
20170510 642246 1071 2017051025836,5/10/2017,5/10/2017,Debit,-10.71,,348322792,POS Transaction 4400072745323 7-ELEVEN               WILSONVILLE  ORUS,Auto & Transport,Debit Card,-117.56
20170510 642246 4243 2017051025835,5/10/2017,5/10/2017,Debit,-42.43,,348322793,POS Transaction ARCO CORNELL 06501 15320 NW CORNELL RD    BEAVERTON    ORUS,,Debit Card,-106.85
20170509 642246 6442 2017050925834,5/9/2017,5/9/2017,Debit,-64.42,,348322794,ACH Debit PAYPAL INSTANT TRANSFER - INST XFER,Transfer,ACH,-64.42
20170509 642246 21521 2017050925833,5/9/2017,5/9/2017,Credit,215.21,,348322795,Overdraft Transfer,Transfer,Transfer,0
20170509 642246 1665 2017050925832,5/9/2017,5/9/2017,Debit,-16.65,,348322796,POS Transaction CHIPOTLE 2686 13535 NW CORNELL RD    PORTLAND     ORUS,Food & Dining,Debit Card,-215.21
20170509 642246 5070 2017050925831,5/9/2017,5/9/2017,Debit,-50.7,,348322797,POS Transaction THE HOME DEPOT #4001 13700 NS SCIENCE PARK DPORTLAND     ORU,Home,Debit Card,-198.56
20170509 642246 10000 2017050925830,5/9/2017,5/9/2017,Credit,100,,348322798,ATM Deposit UNITUS COMMUNITY CU 11200 SW BARNES RD     PORTLAND     ORUS,,Debit Card,-147.86
20170509 642246 1899 2017050925829,5/9/2017,5/9/2017,Debit,-18.99,,348322799,POS Transaction 13510024 KOHLS 100 11055 SW CAN BEAVERTON    ORUS,Shopping,Debit Card,-247.86
20170508 642246 158470 2017050825828,5/8/2017,5/8/2017,Debit,-1584.7,,348322800,ACH Debit WF HOME MTG ACH - AUTO PAY,,ACH,-228.87
20170508 642246 47392 2017050825827,5/8/2017,5/8/2017,Debit,-473.92,,348322801,ACH Debit USAA P&C EXT  - AUTOPAY,,ACH,1355.83
20170508 642246 2450 2017050825826,5/8/2017,5/8/2017,Debit,-24.5,,348322802,ACH Debit PAYPAL INSTANT TRANSFER - INST XFER,Transfer,ACH,1829.75
20170508 642246 712 2017050825825,5/8/2017,5/8/2017,Debit,-7.12,,348322803,POS Transaction 47638 #8 ROTH'S 3045 COMMERC SALEM        ORUS,,Debit Card,1854.25
20170508 642246 1799 2017050825824,5/8/2017,5/8/2017,Debit,-17.99,,348322804,POS Transaction AMZN KINDLE PAYMENT 86 440 TERRY AVE N        866-216-1072 W,,Debit Card,1861.37
20170508 642246 100 2017050825823,5/8/2017,5/8/2017,Debit,-1,,348322805,POS Transaction THE HOME DEPOT #4001 13700 NS SCIENCE PARK DPORTLAND     ORU,Home,Debit Card,1879.36
20170508 642246 1920 2017050825822,5/8/2017,5/8/2017,Debit,-19.2,,348322806,POS Transaction COOPER'S HALL 404 SE 6TH AVE         PORTLAND     ORUS,,Debit Card,1880.36
20170508 642246 2946 2017050825821,5/8/2017,5/8/2017,Debit,-29.46,,348322807,POS Transaction FRED M FUEL #9661 Q76 22075 NW IMBRIE DR     HILLSBORO    OR,,Debit Card,1899.56
20170508 642246 1500 2017050825820,5/8/2017,5/8/2017,Debit,-15,,348322808,POS Transaction SHELL OIL 574431442QPS 12805 NW CORNELL RD    PORTLAND     O,Auto & Transport,Debit Card,1929.02
20170508 642246 2000 2017050825819,5/8/2017,5/8/2017,Debit,-20,,348322809,POS Transaction CHEVRON 0200496 11015 SW CANYON RD     BEAVERTON    ORUS,Auto & Transport,Debit Card,1944.02
20170508 642246 1000 2017050825818,5/8/2017,5/8/2017,Debit,-10,,348322810,POS Transaction PHARMACA INTEGRATIVE P 240 NW LOST SPRINGS TERPORTLAND     O,,Debit Card,1964.02
20170508 642246 18100 2017050825817,5/8/2017,5/8/2017,Debit,-181,,348322811,POS Transaction BNZ*THUSC 515 NW SALTZMAN RD # 82PORTLAND     ORUS,,Debit Card,1974.02
20170508 642246 900 2017050825816,5/8/2017,5/8/2017,Debit,-9,,348322812,Withdrawal Transfer From 4076823 9,Transfer,Withdrawal,2155.02
20170508 642246 800 2017050825815,5/8/2017,5/8/2017,Debit,-8,,348322813,Withdrawal Transfer From 4076823,Transfer,Withdrawal,2164.02
20170508 642246 1707 2017050825814,5/8/2017,5/8/2017,Debit,-17.07,,348322814,POS Transaction 1405308 QUALITY F 7525 SW BARN PORTLAND     ORUS,,Debit Card,2172.02
20170507 642246 5000 2017050725813,5/7/2017,5/7/2017,Debit,-50,,348322815,Withdrawal Transfer From 4076823 Scheduled Recurring Transfer,Transfer,Withdrawal,2189.09
20170507 642246 8901 2017050725812,5/7/2017,5/7/2017,Debit,-89.01,,348322816,POS Transaction THE HOME DEPOT #4001 13700 NS SCIENCE PARK DPORTLAND     ORU,Home,Debit Card,2239.09
20170507 642246 3480 2017050725811,5/7/2017,5/7/2017,Debit,-34.8,,348322817,POS Transaction THE HOME DEPOT #4001 13700 NS SCIENCE PARK DPORTLAND     ORU,Home,Debit Card,2328.1
20170507 642246 2370 2017050725810,5/7/2017,5/7/2017,Debit,-23.7,,348322818,POS Transaction 300008949039 THE UPS STORE #3379 10 PORTLAND     ORUS,Business Services,Debit Card,2362.9
20170506 642246 2342 2017050625809,5/6/2017,5/6/2017,Debit,-23.42,,348322819,POS Transaction THE HOME DEPOT 4018 4401 SW 110TH AVE      BEAVERTON    ORUS,Home,Debit Card,2386.6
20170506 642246 5399 2017050625808,5/6/2017,5/6/2017,Debit,-53.99,,348322820,POS Transaction 13510024 KOHLS 100 11055 SW CAN BEAVERTON    ORUS,Shopping,Debit Card,2410.02
20170506 642246 225 2017050625807,5/6/2017,5/6/2017,Debit,-2.25,,348322821,POS Transaction OREGON PARKING PORTLAN 1225 FERRY ST SE # U   SALEM        O,,Debit Card,2464.01
20170506 642246 225 2017050625806,5/6/2017,5/6/2017,Debit,-2.25,,348322822,POS Transaction CITY OF PORTLAND DEPT 1120 SW 5TH AVE STE    PORTLAND     OR,,Debit Card,2466.26
20170506 642246 15915 2017050625805,5/6/2017,5/6/2017,Debit,-159.15,,348322823,POS Transaction 9115596 WINCO FOO 7330 Nw Butl Hillsboro    ORUS,,Debit Card,2468.51
20170506 642246 200 2017050625804,5/6/2017,5/6/2017,Debit,-2,,348322824,POS Transaction CITY OF PORTLAND DEPT 1120 SW 5TH AVE STE    PORTLAND     OR,,Debit Card,2627.66
20170506 642246 11900 2017050625803,5/6/2017,5/6/2017,Debit,-119,,348322825,POS Transaction BEST BUY LANDSCAPE SUP 2200 NW CORNELIUS PASS HILLSBORO    O,,Debit Card,2629.66
20170506 642246 1033 2017050625802,5/6/2017,5/6/2017,Debit,-10.33,,348322826,POS Transaction QUALITY FOOD CEN 7525 SW BARNES RD      PORTLAND     ORUS,,Debit Card,2748.66
20170506 642246 1281 2017050625801,5/6/2017,5/6/2017,Debit,-12.81,,348322827,POS Transaction QUALITY FOOD CEN 7525 SW BARNES RD      PORTLAND     ORUS,,Debit Card,2758.99
20170506 642246 683 2017050625800,5/6/2017,5/6/2017,Debit,-6.83,,348322828,POS Transaction 222220262414 REI #13 PORTLAND 1405  PORTLAND     ORUS,,Debit Card,2771.8
20170505 642246 28600 2017050525799,5/5/2017,5/5/2017,Debit,-286,,348322829,ACH Debit MULTNOMAH ATHLET FIRST TECH FCU B - BILL PAYMT,,ACH,2778.63
20170505 642246 2899 2017050525798,5/5/2017,5/5/2017,Check,-28.99,6072,348322830,Electronic Check KOHLS DEPT STORE HILLSBORO - 8005645740  SERIAL #: 6072,Shopping,Checks,3064.63
20170505 642246 13990 2017050525797,5/5/2017,5/5/2017,Debit,-139.9,,348322831,POS Transaction CST INTOXALOCK 11035 AURORA AVE       URBANDALE    IAUS,,Debit Card,3093.62
20170505 642246 1000 2017050525796,5/5/2017,5/5/2017,Debit,-10,,348322832,POS Transaction ORCHARD SUPPLY #761 10860 SW BARNES RD     PORTLAND     ORUS,,Debit Card,3233.52
20170504 642246 26655 2017050425795,5/4/2017,5/4/2017,Debit,-266.55,,348322833,ACH Debit AT&T / SBC FIRST TECH FCU B - BILL PAYMT,Bills & Utilities,ACH,3243.52
20170504 642246 14329 2017050425794,5/4/2017,5/4/2017,Debit,-143.29,,348322834,ACH Debit PORTLAND GENERAL FIRST TECH FCU B - BILL PAYMT,,ACH,3510.07
20170504 642246 9741 2017050425793,5/4/2017,5/4/2017,Debit,-97.41,,348322835,ACH Debit COMCAST - BEAVER FIRST TECH FCU B - BILL PAYMT,,ACH,3653.36
20170504 642246 8622 2017050425792,5/4/2017,5/4/2017,Debit,-86.22,,348322836,ACH Debit NW NATURAL GAS FIRST TECH FCU B - BILL PAYMT,,ACH,3750.77
20170504 642246 2296 2017050425791,5/4/2017,5/4/2017,Debit,-22.96,,348322837,ACH Debit WALKER GARBAGE S FIRST TECH FCU B - BILL PAYMT,,ACH,3836.99
20170504 642246 700 2017050425790,5/4/2017,5/4/2017,Debit,-7,,348322838,POS Transaction CTY CTR PARKNG 061018 600 NE GRAND AVE       PORTLAND     OR,,Debit Card,3859.95
20170504 642246 2495 2017050425789,5/4/2017,5/4/2017,Debit,-24.95,,348322839,POS Transaction  AMAZON.COM             SEATTLE      WAUS,,Debit Card,3866.95
20170504 642246 3500 2017050425788,5/4/2017,5/4/2017,Debit,-35,,345261085,Withdrawal Transfer From 4076823,Transfer,Withdrawal,3891.9
20170504 642246 1666 2017050425787,5/4/2017,5/4/2017,Debit,-16.66,,345260993,POS Transaction THE HOME DEPOT 4018 4401 SW 110TH AVE      BEAVERTON    ORUS,Home,Debit Card,3926.9
20170504 642246 299 2017050425786,5/4/2017,5/4/2017,Debit,-2.99,,345260994,POS Transaction PEACHWAVE FROZENYOGU 3205 SW CEDAR HILLS #2 BEAVERTON    ORU,,Debit Card,3943.56
20170504 642246 499 2017050425785,5/4/2017,5/4/2017,Debit,-4.99,,345260995,POS Transaction GOOGLE *Big Fish Games 1600 Amphitheatre Pkwy g.co/payhelp#C,Entertainment,Debit Card,3946.55
20170504 642246 2000 2017050425784,5/4/2017,5/4/2017,Debit,-20,,345260996,Withdrawal Transfer From 4076823 For a car budget,Transfer,Withdrawal,3951.54
20170504 642246 770 2017050425783,5/4/2017,5/4/2017,Debit,-7.7,,345260997,POS Transaction CHIPOTLE 0512 3380 SW CEDAR HILLS    BEAVERTON    ORUS,Food & Dining,Debit Card,3971.54
20170504 642246 1679 2017050425782,5/4/2017,5/4/2017,Debit,-16.79,,345260998,POS Transaction THE HOME DEPOT #4001 13700 NS SCIENCE PARK DPORTLAND     ORU,Home,Debit Card,3979.24
20170504 642246 1572 2017050425781,5/4/2017,5/4/2017,Debit,-15.72,,345260999,POS Transaction 1405308 QUALITY F 7525 SW BARN PORTLAND     ORUS,,Debit Card,3996.03
20170504 642246 4000 2017050425780,5/4/2017,5/4/2017,Debit,-40,,345261000,POS Transaction ARCO CORNELL 06501 15320 NW CORNELL RD    BEAVERTON    ORUS,,Debit Card,4011.75
20170504 642246 329 2017050425779,5/4/2017,5/4/2017,Debit,-3.29,,345261001,POS Transaction ARCO CORNELL 06501 15320 NW CORNELL RD    BEAVERTON    ORUS,,Debit Card,4051.75
20170503 642246 225 2017050325778,5/3/2017,5/3/2017,Debit,-2.25,,345261002,POS Transaction OREGON PARKING PORTLAN 1225 FERRY ST SE # U   SALEM        O,,Debit Card,4055.04
20170503 642246 225 2017050325777,5/3/2017,5/3/2017,Debit,-2.25,,345261003,POS Transaction OREGON PARKING PORTLAN 1225 FERRY ST SE # U   SALEM        O,,Debit Card,4057.29
20170503 642246 40000 2017050325776,5/3/2017,5/3/2017,Debit,-400,,345261004,Withdrawal Transfer From 4076823 Scheduled Recurring Transfer,Transfer,Withdrawal,4059.54
20170503 642246 5499 2017050325775,5/3/2017,5/3/2017,Debit,-54.99,,345261005,POS Transaction ZAP*ZAPPOS.COM 400 E Stewart Ave      800-927-7671 NVUS,,Debit Card,4459.54
20170502 642246 250 2017050225774,5/2/2017,5/2/2017,Debit,-2.5,,345261006,POS Transaction TRIMET TVM 4012 SE 17TH AVE       PORTLAND     ORUS,,Debit Card,4514.53
20170502 642246 225 2017050225773,5/2/2017,5/2/2017,Debit,-2.25,,345261007,POS Transaction OREGON PARKING PORTLAN 1225 FERRY ST SE # U   SALEM        O,,Debit Card,4517.03
20170502 642246 3500 2017050225772,5/2/2017,5/2/2017,Debit,-35,,344510931,Withdrawal Transfer From 4076823,Transfer,Withdrawal,4519.28
20170502 642246 7000 2017050225771,5/2/2017,5/2/2017,Debit,-70,,344510717,POS Transaction CAR TOYS BEAVERTON 12195 SW CANYON RD     BEAVERTON    ORUS,,Debit Card,4554.28
20170502 642246 100 2017050225770,5/2/2017,5/2/2017,Debit,-1,,344510718,POS Transaction SQUARE *SQ *CAFE 8 399-301 Northeast HollaPortland     ORUS,,Debit Card,4624.28
20170502 642246 4181 2017050225769,5/2/2017,5/2/2017,Debit,-41.81,,344510719,POS Transaction THE HOME DEPOT #4001 13700 NS SCIENCE PARK DPORTLAND     ORU,Home,Debit Card,4625.28
20170502 642246 1503 2017050225766,5/2/2017,5/2/2017,Debit,-15.03,,344291325,POS Transaction 90384198 OFFICE DE 2595 S.W. CE BEAVERTON    ORUS,,Debit Card,5034.05
20170501 642246 35696 2017050125768,5/1/2017,5/1/2017,Debit,-356.96,,344312035,Withdrawal Transfer From 4076823,Transfer,Withdrawal,4667.09
20170501 642246 1000 2017050125767,5/1/2017,5/1/2017,Debit,-10,,344292405,Withdrawal Transfer From 4076823,Transfer,Withdrawal,5024.05
20170501 642246 2800 2017050125765,5/1/2017,5/1/2017,Debit,-28,,344291326,ACH Debit PAYPAL INSTANT TRANSFER - INST XFER,Transfer,ACH,5049.08
20170501 642246 325 2017050125764,5/1/2017,5/1/2017,Debit,-3.25,,344291327,POS Transaction SQ *DUTCH BROS COFF 711 SOUTHWEST 26TH STRECORVALLIS    ORUS,,Debit Card,5077.08
20170501 642246 11400 2017050125763,5/1/2017,5/1/2017,Debit,-114,,344291328,POS Transaction VIVID EYE CARE 6506 NE CAMPUS WAY     HILLSBORO    ORUS,,Debit Card,5080.33
20170501 642246 997 2017050125762,5/1/2017,5/1/2017,Debit,-9.97,,344291329,POS Transaction NY TIMES NATL SALES 620 Eighth Ave 22nd Fl 800-698-4637 NYUS,,Debit Card,5194.33
20170501 642246 4200 2017050125761,5/1/2017,5/1/2017,Debit,-42,,344291330,POS Transaction SERENITY NAIL SPA 10960 SW BARNES RD     PORTLAND     ORUS,,Debit Card,5204.3
20170501 642246 5000 2017050125760,5/1/2017,5/1/2017,Debit,-50,,344291331,POS Transaction CARINA LOUNGE 410 NW 21ST AVE        PORTLAND     ORUS,,Debit Card,5246.3
20170501 642246 5450 2017050125759,5/1/2017,5/1/2017,Debit,-54.5,,344291332,POS Transaction ADIDAS 6536 5055 N GREELEY AVE     PORTLAND     ORUS,,Debit Card,5296.3
20170501 642246 900 2017050125758,5/1/2017,5/1/2017,Debit,-9,,344291333,Withdrawal Transfer From 4076823 9,Transfer,Withdrawal,5350.8
20170501 642246 509720 2017050125757,5/1/2017,5/1/2017,Credit,5097.2,,344291334,ACH Deposit HEALTH AUTHORITY STATE OF OREGON - DIRECT DEP,,ACH,5359.8
20170501 642246 3550 2017050125756,5/1/2017,5/1/2017,Debit,-35.5,,344291335,POS Transaction ARCO CORNELL 06501 15320 NW CORNELL RD    BEAVERTON    ORUS,,Debit Card,262.6
20170430 642246 261 2017043025755,4/30/2017,4/30/2017,Credit,2.61,,344291336,Credit Dividend,,,298.1
20170430 642246 521 2017043025754,4/30/2017,4/30/2017,Debit,-5.21,,344291337,POS Transaction Wal-Mart Super Center 3146 WAL-SAMS          CORVALLIS    OR,Shopping,Debit Card,295.49
20170430 642246 800 2017043025753,4/30/2017,4/30/2017,Debit,-8,,344291338,Withdrawal Transfer From 4076823,Transfer,Withdrawal,300.7
20170430 642246 2128 2017043025752,4/30/2017,4/30/2017,Debit,-21.28,,344291339,POS Transaction 1405308 QUALITY F 7525 SW BARN PORTLAND     ORUS,,Debit Card,308.7
20170430 642246 1127 2017043025751,4/30/2017,4/30/2017,Debit,-11.27,,344291340,POS Transaction ORCHARD SUPPLY #761 10860 SW BARNES RD     PORTLAND     ORUS,,Debit Card,329.98
20170429 642246 4593 2017042925750,4/29/2017,4/29/2017,Debit,-45.93,,344291341,POS Transaction CORNELL FARM 8212 SW BARNES ROA     PORTLAND     ORUS,,Debit Card,341.25
20170429 642246 1000 2017042925749,4/29/2017,4/29/2017,Debit,-10,,343478244,Withdrawal Transfer From 4076823,Transfer,Withdrawal,387.18
20170429 642246 17313 2017042925748,4/29/2017,4/29/2017,Debit,-173.13,,343478156,POS Transaction 9115596 WINCO FOO 7330 Nw Butl Hillsboro    ORUS,,Debit Card,397.18
20170429 642246 1999 2017042925747,4/29/2017,4/29/2017,Debit,-19.99,,343478157,POS Transaction 22835116 HOMEGOODS 7650 NE BUTL HILLSBORO    ORUS,,Debit Card,570.31
20170429 642246 150 2017042925746,4/29/2017,4/29/2017,Debit,-1.5,,343478158,POS Transaction OREGON PARKING PORTLAN 1225 FERRY ST SE # U   SALEM        O,,Debit Card,590.3
20170429 642246 4965 2017042925745,4/29/2017,4/29/2017,Debit,-49.65,,343478159,POS Transaction THE HOME DEPOT #4001 13700 NS SCIENCE PARK DPORTLAND     ORU,Home,Debit Card,591.8
20170429 642246 4234 2017042925744,4/29/2017,4/29/2017,Debit,-42.34,,343478160,POS Transaction FRED M FUEL #9661 Q76 22075 NW IMBRIE DR     HILLSBORO    OR,,Debit Card,641.45
20170429 642246 3701 2017042925743,4/29/2017,4/29/2017,Debit,-37.01,,343478161,POS Transaction ARCO CORNELL 06501 15320 NW CORNELL RD    BEAVERTON    ORUS,,Debit Card,683.79
20170429 642246 800 2017042925742,4/29/2017,4/29/2017,Debit,-8,,343478162,POS Transaction SQU*SQ *KAADY CAR WASH 10270 Southwest Canyon Beaverton    O,,Debit Card,720.8
20170429 642246 199 2017042925741,4/29/2017,4/29/2017,Debit,-1.99,,343478163,POS Transaction GOOGLE *Google Storage 1600 Amphitheatre Pkwy 855-492-5538 C,Entertainment,Debit Card,728.8
20170429 642246 2598 2017042925740,4/29/2017,4/29/2017,Debit,-25.98,,343478164,POS Transaction MY M   MS 000900099994 700 HIGH ST            HACKETTSTOWN N,,Debit Card,730.79
20170429 642246 1475 2017042925739,4/29/2017,4/29/2017,Debit,-14.75,,343478165,POS Transaction 694146 TRADER JOE'S #         PORTLAND     ORUS,,Debit Card,756.77
20170428 642246 449 2017042825738,4/28/2017,4/28/2017,Debit,-4.49,,343478166,POS Transaction NEW SEASON MARKET -#3 1453 NE 61ST AVE       HILLSBORO    OR,,Debit Card,771.52
20170428 642246 239 2017042825737,4/28/2017,4/28/2017,Debit,-2.39,,343478167,POS Transaction PHARMACA INTEGRATIVE P 240 NW LOST SPRINGS TERPORTLAND     O,,Debit Card,776.01
20170428 642246 350 2017042825736,4/28/2017,4/28/2017,Debit,-3.5,,343478168,POS Transaction OREGON PARKING PORTLAN 1225 FERRY ST SE # U   SALEM        O,,Debit Card,778.4
20170428 642246 225 2017042825735,4/28/2017,4/28/2017,Debit,-2.25,,343478169,POS Transaction OREGON PARKING PORTLAN 1225 FERRY ST SE # U   SALEM        O,,Debit Card,781.9
20170428 642246 285 2017042825734,4/28/2017,4/28/2017,Debit,-2.85,,343478170,POS Transaction USA*USA*CANTEEN PORTLA 12670 SW HALL BLVD. BLDPORTLAND     O,,Debit Card,784.15
20170428 642246 199 2017042825733,4/28/2017,4/28/2017,Debit,-1.99,,343478171,POS Transaction AMAZON SERVICES-KINDLE 440 TERRY AVE N        866-216-1072 W,Shopping,Debit Card,787
20170428 642246 998 2017042825732,4/28/2017,4/28/2017,Debit,-9.98,,343478172,POS Transaction 694146 TRADER JOE'S #         PORTLAND     ORUS,,Debit Card,788.99
20170428 642246 1107 2017042825731,4/28/2017,4/28/2017,Debit,-11.07,,343478173,POS Transaction QUALITY FOOD CEN 7525 SW BARNES RD      PORTLAND     ORUS,,Debit Card,798.97
20170427 642246 225 2017042725730,4/27/2017,4/27/2017,Debit,-2.25,,343478174,POS Transaction OREGON PARKING PORTLAN 1225 FERRY ST SE # U   SALEM        O,,Debit Card,810.04
20170427 642246 1646 2017042725729,4/27/2017,4/27/2017,Debit,-16.46,,343478175,POS Transaction 1405308 QUALITY F 7525 SW BARN PORTLAND     ORUS,,Debit Card,812.29
20170427 642246 4657 2017042725728,4/27/2017,4/27/2017,Credit,46.57,,343478176,ACH Deposit ALLEGIANCE BENEF PRETAX BENEFIT TRANS - CLAIM REIM,,ACH,828.75
20170427 642246 100 2017042725727,4/27/2017,4/27/2017,Debit,-1,,343478177,POS Transaction THE HOME DEPOT #4001 13700 NS SCIENCE PARK DPORTLAND     ORU,Home,Debit Card,782.18
20170427 642246 2693 2017042725725,4/27/2017,4/27/2017,Debit,-26.93,,342589498,POS Transaction 1405308 QUALITY F 7525 SW BARN PORTLAND     ORUS,,Debit Card,1003.18
20170427 642246 682 2017042725724,4/27/2017,4/27/2017,Debit,-6.82,,342589499,POS Transaction QUALITY FOOD CEN 7525 SW BARNES RD      PORTLAND     ORUS,,Debit Card,1030.11
20170426 642246 22000 2017042625726,4/26/2017,4/26/2017,Debit,-220,,342590510,Withdrawal Transfer From 4076823,Transfer,Withdrawal,783.18
20170426 642246 29288 2017042625723,4/26/2017,4/26/2017,Debit,-292.88,,342589500,ACH Debit BKAMERICA  - IC PAYMENT,,ACH,1036.93
20170426 642246 4550 2017042625722,4/26/2017,4/26/2017,Debit,-45.5,,342589501,POS Transaction ADIDAS 6536 5055 N GREELEY AVE     PORTLAND     ORUS,,Debit Card,1329.81
20170426 642246 3250 2017042625721,4/26/2017,4/26/2017,Credit,32.5,,342589502,Credit ADIDAS 6536 5055 N GREELEY AVE     PORTLAND     ORUS,,,1375.31
20170426 642246 225 2017042625720,4/26/2017,4/26/2017,Debit,-2.25,,342589503,POS Transaction OREGON PARKING PORTLAN 1225 FERRY ST SE # U   SALEM        O,,Debit Card,1342.81
20170426 642246 325 2017042625719,4/26/2017,4/26/2017,Debit,-3.25,,342589504,POS Transaction OREGON PARKING PORTLAN 1225 FERRY ST SE # U   SALEM        O,,Debit Card,1345.06
20170426 642246 5000 2017042625718,4/26/2017,4/26/2017,Debit,-50,,342229292,Withdrawal Transfer From 4076823,Transfer,Withdrawal,1348.31
20170426 642246 1000 2017042625717,4/26/2017,4/26/2017,Debit,-10,,342202199,Withdrawal Transfer From 4076823,Transfer,Withdrawal,1398.31
20170426 642246 6940 2017042625716,4/26/2017,4/26/2017,Debit,-69.4,,342201386,POS Transaction THE HOME DEPOT #4001 13700 NS SCIENCE PARK DPORTLAND     ORU,Home,Debit Card,1408.31
20170425 642246 18500 2017042525715,4/25/2017,4/24/2017,Check,-185,6094,342201387,Check #6094,,Checks,1477.71
20170425 642246 18000 2017042525714,4/25/2017,4/24/2017,Check,-180,6114,342201388,Check #6114,,Checks,1662.71
20170425 642246 13000 2017042525713,4/25/2017,4/24/2017,Check,-130,6067,342201389,Check #6067,,Checks,1842.71
20170425 642246 3800 2017042525712,4/25/2017,4/24/2017,Check,-38,6115,342201390,Check #6115,,Checks,1972.71
20170425 642246 668 2017042525711,4/25/2017,4/25/2017,Debit,-6.68,,342201391,POS Transaction NEW SEASONS MARKET # 11 14805 SW BARROWS RD.   BEAVERTON,,Debit Card,2010.71
20170425 642246 4000 2017042525710,4/25/2017,4/25/2017,Debit,-40,,342201392,POS Transaction ARCO CORNELL 06501 15320 NW CORNELL RD    BEAVERTON    ORUS,,Debit Card,2017.39
20170425 642246 1126 2017042525709,4/25/2017,4/25/2017,Debit,-11.26,,342201393,POS Transaction NEW SEASONS MARKET # 11 14805 SW BARROWS RD.   BEAVERTON,,Debit Card,2057.39
20170425 642246 13360 2017042525708,4/25/2017,4/25/2017,Debit,-133.6,,342201394,POS Transaction TAP PLASTICS #12 2842 NE SANDY BLVD     PORTLAND     ORUS,,Debit Card,2068.65
20170425 642246 225 2017042525707,4/25/2017,4/25/2017,Debit,-2.25,,342201395,POS Transaction OREGON PARKING PORTLAN 1225 FERRY ST SE # U   SALEM        O,,Debit Card,2202.25
20170425 642246 170 2017042525706,4/25/2017,4/25/2017,Debit,-1.7,,342201396,POS Transaction SQUARE *SQ *CAFE 8 800 NE Oregon Street   Portland     ORUS,,Debit Card,2204.5
20170425 642246 100 2017042525705,4/25/2017,4/25/2017,Debit,-1,,342201397,POS Transaction SQUARE *SQ *CAFE 8 800 NE Oregon Street   Portland     ORUS,,Debit Card,2206.2
20170425 642246 30000 2017042525704,4/25/2017,4/25/2017,Debit,-300,,342201398,Withdrawal Transfer From 4076823 Vacation #CT,Transfer,Withdrawal,2207.2
20170425 642246 12145 2017042525703,4/25/2017,4/25/2017,Debit,-121.45,,342201399,POS Transaction BEST BUY LANDSCAPE SUP 2200 NW CORNELIUS PASS HILLSBORO    O,,Debit Card,2507.2
20170425 642246 900 2017042525702,4/25/2017,4/25/2017,Debit,-9,,342201400,Withdrawal Transfer From 4076823 9,Transfer,Withdrawal,2628.65
20170425 642246 3500 2017042525699,4/25/2017,4/25/2017,Credit,35,,341940324,ATM Deposit UNITUS COMMUNITY CU 11200 SW BARNES RD     PORTLAND     ORUS,,Debit Card,2891.71
20170425 642246 1308 2017042525698,4/25/2017,4/25/2017,Debit,-13.08,,341940325,POS Transaction QUALITY FOOD CEN 7525 SW BARNES RD      PORTLAND     ORUS,,Debit Card,2856.71
20170424 642246 13391 2017042425701,4/24/2017,4/24/2017,Debit,-133.91,,341940322,ACH Debit FEDLOANSERVICING ACH TRANSACTION - STDNT LOAN,,ACH,2637.65
20170424 642246 12015 2017042425700,4/24/2017,4/24/2017,Debit,-120.15,,341940323,ACH Debit USAA.COM PAY EXT ACH PAYMENTS - LIFE,,ACH,2771.56
20170424 642246 2237 2017042425697,4/24/2017,4/24/2017,Debit,-22.37,,341940326,POS Transaction JO-ANN STORE #2101 7270 NE BUTLER ST      HILLSBORO    ORUS,Shopping,Debit Card,2869.79
20170424 642246 1749 2017042425696,4/24/2017,4/24/2017,Credit,17.49,,341940327,Credit JO-ANN STORE #2101 7270 NE BUTLER ST      HILLSBORO    ORUS,Shopping,,2892.16
20170424 642246 7600 2017042425695,4/24/2017,4/24/2017,Debit,-76,,341940328,POS Transaction HUGHES WATER GARDENS 25289 SW STAFFORD RD   TUALATIN     ORU,,Debit Card,2874.67
20170424 642246 1998 2017042425694,4/24/2017,4/24/2017,Debit,-19.98,,341940329,POS Transaction JO-ANN STORE #2101 7270 NE BUTLER ST      HILLSBORO    ORUS,Shopping,Debit Card,2950.67
20170424 642246 999 2017042425693,4/24/2017,4/24/2017,Debit,-9.99,,341940330,POS Transaction  NETFLIX COM            LOS GATOS    CAUS,,Debit Card,2970.65
20170424 642246 1700 2017042425692,4/24/2017,4/24/2017,Debit,-17,,341940331,POS Transaction POLLO NORTE 2 2935 NE GLISAN ST      PORTLAND     ORUS,,Debit Card,2980.64
20170424 642246 4675 2017042425691,4/24/2017,4/24/2017,Debit,-46.75,,341940332,POS Transaction FRED M FUEL #9661 Q76 22075 NW IMBRIE DR     HILLSBORO    OR,,Debit Card,2997.64
20170424 642246 100 2017042425690,4/24/2017,4/24/2017,Debit,-1,,341940333,POS Transaction CITY OF PORTLAND DEPT 1120 SW 5TH AVE STE    PORTLAND     OR,,Debit Card,3044.39
20170424 642246 4200 2017042425689,4/24/2017,4/24/2017,Debit,-42,,341940334,POS Transaction CLB*Vancouver Bicycle 1930 Thoreau Dr N      SCHAUMBURG   IL,,Debit Card,3045.39
20170424 642246 1224 2017042425688,4/24/2017,4/24/2017,Debit,-12.24,,341940335,POS Transaction SQU*SQ *SALT & STRAW 2525 Southeast 33rd PlaPortland     ORU,,Debit Card,3087.39
20170424 642246 2236 2017042425687,4/24/2017,4/24/2017,Debit,-22.36,,341940336,POS Transaction 225179141992 DENNIS SEVEN DEES CEDA PORTLAND     ORUS,,Debit Card,3099.63
20170423 642246 800 2017042325686,4/23/2017,4/23/2017,Debit,-8,,341940337,Withdrawal Transfer From 4076823,Transfer,Withdrawal,3121.99
20170423 642246 2790 2017042325685,4/23/2017,4/23/2017,Debit,-27.9,,341940338,POS Transaction 9115596 WINCO FOO 7330 Nw Butl Hillsboro    ORUS,,Debit Card,3129.99
20170423 642246 2397 2017042325684,4/23/2017,4/23/2017,Credit,23.97,,341940339,Credit AMAZON.COM REFUNDAMAZON.COM       SEATTLE      WAUS,,,3157.89
20170423 642246 8779 2017042325683,4/23/2017,4/23/2017,Debit,-87.79,,341940340,POS Transaction  AMAZON.COM             SEATTLE      WAUS,,Debit Card,3133.92
20170423 642246 1000 2017042325682,4/23/2017,4/23/2017,Debit,-10,,341703701,Withdrawal Transfer From 4076823,Transfer,Withdrawal,3221.71
20170423 642246 4602 2017042325681,4/23/2017,4/23/2017,Debit,-46.02,,341703664,POS Transaction 225179141992 DENNIS SEVEN DEES CEDA PORTLAND     ORUS,,Debit Card,3231.71
20170422 642246 1547 2017042225680,4/22/2017,4/22/2017,Debit,-15.47,,341645977,POS Transaction THE HOME DEPOT #4001 13700 NS SCIENCE PARK DPORTLAND     ORU,Home,Debit Card,3277.73
20170422 642246 4249 2017042225679,4/22/2017,4/22/2017,Debit,-42.49,,341645978,POS Transaction 1351004 KOHLS 100 7360 NE BUTL HILLSBORO    ORUS,Shopping,Debit Card,3293.2
20170422 642246 10938 2017042225678,4/22/2017,4/22/2017,Debit,-109.38,,341645979,POS Transaction 9115596 WINCO FOO 7330 Nw Butl Hillsboro    ORUS,,Debit Card,3335.69
20170422 642246 4457 2017042225677,4/22/2017,4/22/2017,Credit,44.57,,341645980,Credit NORDSTROM-RACK #0027 181 NW EVERGREEN PARKWABEAVERTON    ORU,,,3445.07
20170422 642246 524 2017042225676,4/22/2017,4/22/2017,Debit,-5.24,,341645981,POS Transaction NEW SEASON MARKET -#3 1453 NE 61ST AVE       HILLSBORO    OR,,Debit Card,3400.5
20170422 642246 2027 2017042225675,4/22/2017,4/22/2017,Debit,-20.27,,341645982,POS Transaction THE HOME DEPOT #4001 13700 NS SCIENCE PARK DPORTLAND     ORU,Home,Debit Card,3405.74
20170422 642246 230 2017042225674,4/22/2017,4/22/2017,Debit,-2.3,,341645983,POS Transaction CAMBRIDGE FINE CLE 11130 SW Barnes Rd     503-643-7217 ORUS,,Debit Card,3426.01
20170422 642246 1800 2017042225673,4/22/2017,4/22/2017,Debit,-18,,341645984,POS Transaction GROUPON INC 600 W Chicago Ave      877-788-7858 ILUS,,Debit Card,3428.31
20170422 642246 649 2017042225672,4/22/2017,4/22/2017,Debit,-6.49,,341645985,POS Transaction 40785 BALES CED 1881 SW NAIT PORTLAND     ORUS,,Debit Card,3446.31
20170422 642246 33500 2017042225671,4/22/2017,4/22/2017,Debit,-335,,341645986,Withdrawal Transfer From 4076823,Transfer,Withdrawal,3452.8
20170422 642246 5000 2017042225670,4/22/2017,4/22/2017,Debit,-50,,341645987,Withdrawal Transfer From 4076823,Transfer,Withdrawal,3787.8
20170422 642246 40000 2017042225669,4/22/2017,4/22/2017,Debit,-400,,341645988,Withdrawal Transfer From 4076823,Transfer,Withdrawal,3837.8
20170422 642246 5000 2017042225668,4/22/2017,4/22/2017,Debit,-50,,341645989,Withdrawal Transfer From 4076823,Transfer,Withdrawal,4237.8
20170422 642246 35000 2017042225667,4/22/2017,4/22/2017,Debit,-350,,341645990,Withdrawal Transfer From 4076823 Pay off this SOB!,Transfer,Withdrawal,4287.8
20170422 642246 125 2017042225666,4/22/2017,4/22/2017,Debit,-1.25,,341645991,POS Transaction OREGON PARKING PORTLAN 1225 FERRY ST SE # U   SALEM        O,,Debit Card,4637.8
20170422 642246 125 2017042225665,4/22/2017,4/22/2017,Debit,-1.25,,341645992,POS Transaction OREGON PARKING PORTLAN 1225 FERRY ST SE # U   SALEM        O,,Debit Card,4639.05
20170422 642246 1420 2017042225664,4/22/2017,4/22/2017,Debit,-14.2,,341476633,POS Transaction QUALITY FOOD CEN 7525 SW BARNES RD      PORTLAND     ORUS,,Debit Card,4640.3
20170422 642246 318 2017042225663,4/22/2017,4/22/2017,Debit,-3.18,,341476634,POS Transaction 300000064127 664 /2OR009 SEES CAND BEAVERTON    ORUS,,Debit Card,4654.5
20170421 642246 500 2017042125662,4/21/2017,4/21/2017,Debit,-5,,341476635,ACH Debit OPB  - DONATION,,ACH,4657.68
20170421 642246 520 2017042125661,4/21/2017,4/21/2017,Debit,-5.2,,341476636,POS Transaction QUALITY FOOD CEN 7525 SW BARNES RD      PORTLAND     ORUS,,Debit Card,4662.68
20170421 642246 2000 2017042125660,4/21/2017,4/21/2017,Debit,-20,,341476637,POS Transaction GROUPON INC 600 W Chicago Ave      877-788-7858 ILUS,,Debit Card,4667.88
20170421 642246 16600 2017042125659,4/21/2017,4/21/2017,Debit,-166,,341476638,POS Transaction ADIDAS 6536 5055 N GREELEY AVE     PORTLAND     ORUS,,Debit Card,4687.88
20170421 642246 455 2017042125658,4/21/2017,4/21/2017,Debit,-4.55,,341476639,POS Transaction QUALITY FOOD CEN 7525 SW BARNES RD      PORTLAND     ORUS,,Debit Card,4853.88
20170421 642246 285 2017042125657,4/21/2017,4/21/2017,Debit,-2.85,,341476640,POS Transaction USA*USA*CANTEEN PORTLA 12670 SW HALL BLVD. BLDPORTLAND     O,,Debit Card,4858.43
20170421 642246 1599 2017042125656,4/21/2017,4/21/2017,Debit,-15.99,,341184928,POS Transaction CORNELL FARM 8212 SW BARNES ROA     PORTLAND     ORUS,,Debit Card,4861.28
20170421 642246 4000 2017042125655,4/21/2017,4/21/2017,Debit,-40,,341184929,POS Transaction ARCO CORNELL 06501 15320 NW CORNELL RD    BEAVERTON    ORUS,,Debit Card,4877.27
20170421 642246 499 2017042125654,4/21/2017,4/21/2017,Debit,-4.99,,341184930,POS Transaction QUALITY FOOD CEN 7525 SW BARNES RD      PORTLAND     ORUS,,Debit Card,4917.27
20170420 642246 200 2017042025653,4/20/2017,4/20/2017,Debit,-2,,341184931,POS Transaction CITY OF PORTLAND DEPT 1120 SW 5TH AVE STE    PORTLAND     OR,,Debit Card,4922.26
20170420 642246 225 2017042025652,4/20/2017,4/20/2017,Debit,-2.25,,340948304,POS Transaction OREGON PARKING PORTLAN 1225 FERRY ST SE # U   SALEM        O,,Debit Card,4924.26
20170420 642246 490858 2017042025651,4/20/2017,4/20/2017,Credit,4908.58,,340948305,ACH Deposit BEAVERTON SCHOOL PAYROLL 1701004 - PAYROLL,,ACH,4926.51
20170419 642246 225 2017041925650,4/19/2017,4/19/2017,Debit,-2.25,,340674699,POS Transaction OREGON PARKING PORTLAN 1225 FERRY ST SE # U   SALEM        O,,Debit Card,17.93
20170419 642246 285 2017041925649,4/19/2017,4/19/2017,Debit,-2.85,,340674700,POS Transaction USA*USA*CANTEEN PORTLA 12670 SW HALL BLVD. BLDPORTLAND     O,,Debit Card,20.18
20170419 642246 99 2017041925648,4/19/2017,4/19/2017,Debit,-0.99,,340674701,POS Transaction GOOGLE *Big Fish Games 1600 Amphitheatre Pkwy g.co/payhelp#C,Entertainment,Debit Card,23.03
20170419 642246 99 2017041925647,4/19/2017,4/19/2017,Debit,-0.99,,340674702,POS Transaction GOOGLE *Big Fish Games 1600 Amphitheatre Pkwy g.co/payhelp#C,Entertainment,Debit Card,24.02
20170419 642246 499 2017041925646,4/19/2017,4/19/2017,Debit,-4.99,,340674703,POS Transaction GOOGLE *Big Fish Games 1600 Amphitheatre Pkwy g.co/payhelp#C,Entertainment,Debit Card,25.01
20170418 642246 3500 2017041825645,4/18/2017,4/18/2017,Credit,35,,340410576,Deposit Transfer To 4076823,Transfer,,30
20170418 642246 500 2017041825644,4/18/2017,4/18/2017,Check,-5,6116,340410267,Electronic Check FIRST UNITARIAN  - CHECKPAYMT  SERIAL #: 6116,,Checks,-5
20170418 642246 5727 2017041825643,4/18/2017,4/18/2017,Credit,57.27,,340410268,Overdraft Transfer,Transfer,Transfer,0
20170418 642246 2149 2017041825642,4/18/2017,4/14/2017,Debit,-21.49,,340410269,Descriptive Withdrawal AMAZON.COM                 SEATTLE        WAUSAAMAZON.COM,,Withdrawal,-57.27
20170418 642246 99 2017041825641,4/18/2017,4/18/2017,Debit,-0.99,,340410270,POS Transaction AMAZON SERVICES-KINDLE 440 TERRY AVE N        866-216-1072 W,Shopping,Debit Card,-35.78
20170418 642246 700 2017041825640,4/18/2017,4/18/2017,Debit,-7,,340410271,POS Transaction CTY CTR PARKNG 061018 600 NE GRAND AVE       PORTLAND     OR,,Debit Card,-34.79
20170418 642246 1800 2017041825639,4/18/2017,4/18/2017,Debit,-18,,340410272,POS Transaction SERENITY NAIL SPA 10960 SW BARNES RD     PORTLAND     ORUS,,Debit Card,-27.79
20170418 642246 399 2017041825638,4/18/2017,4/18/2017,Debit,-3.99,,340410273,POS Transaction 40785 BALES CED 1881 SW NAIT PORTLAND     ORUS,,Debit Card,-9.79
20170417 642246 799 2017041725637,4/17/2017,4/17/2017,Credit,7.99,,340410274,Credit AMAZON.COM REFUNDAMAZON.COM       SEATTLE      WAUS,,,-5.8
20170417 642246 1800 2017041725636,4/17/2017,4/17/2017,Debit,-18,,340410275,ACH Debit PAYPAL INSTANT TRANSFER - INST XFER,Transfer,ACH,-13.79
20170417 642246 1033 2017041725635,4/17/2017,4/17/2017,Debit,-10.33,,340410276,ACH Debit SAFECO INSURANCE  - INS PREM,,ACH,4.21
20170417 642246 524 2017041725634,4/17/2017,4/17/2017,Debit,-5.24,,340410277,ACH Debit PAYPAL INSTANT TRANSFER - INST XFER,Transfer,ACH,14.54
20170417 642246 2200 2017041725633,4/17/2017,4/17/2017,Debit,-22,,340410278,POS Transaction SALVADOR MOLLYS RG LLC 1523 SW SUNSET BLVD    PORTLAND     O,,Debit Card,19.78
20170417 642246 1399 2017041725632,4/17/2017,4/17/2017,Debit,-13.99,,340410279,POS Transaction BEAVERTON BAKERY 12375 SW BROADWAY ST   BEAVERTON    ORUS,,Debit Card,41.78
20170417 642246 824 2017041725631,4/17/2017,4/17/2017,Debit,-8.24,,340410280,POS Transaction KITCHEN KABOODLE-ORENC 1415 NE 61ST AVE       HILLSBORO    O,,Debit Card,55.77
20170417 642246 4245 2017041725630,4/17/2017,4/17/2017,Debit,-42.45,,340410281,POS Transaction FRED M FUEL #9661 Q76 22075 NW IMBRIE DR     HILLSBORO    OR,,Debit Card,64.01
20170417 642246 7454 2017041725629,4/17/2017,4/17/2017,Debit,-74.54,,340410282,POS Transaction NORDSTROM-RACK #0028 245 SW MORRISON ST     PORTLAND     ORU,,Debit Card,106.46
20170417 642246 1000 2017041725628,4/17/2017,4/17/2017,Debit,-10,,340410283,POS Transaction SHELL OIL 574431442QPS 12805 NW CORNELL RD    PORTLAND     O,Auto & Transport,Debit Card,181
20170417 642246 99 2017041725627,4/17/2017,4/17/2017,Debit,-0.99,,340410284,POS Transaction GOOGLE *Big Fish Games 1600 Amphitheatre Pkwy g.co/payhelp#C,Entertainment,Debit Card,191
20170417 642246 900 2017041725626,4/17/2017,4/17/2017,Debit,-9,,340410285,Withdrawal Transfer From 4076823 9,Transfer,Withdrawal,191.99
20170416 642246 584 2017041625625,4/16/2017,4/16/2017,Debit,-5.84,,340410286,POS Transaction QUALITY FOOD CEN 7525 SW BARNES RD      PORTLAND     ORUS,,Debit Card,200.99
20170415 642246 199 2017041525624,4/15/2017,4/15/2017,Debit,-1.99,,340410287,POS Transaction 300000064127 664 /2OR009 SEES CAND BEAVERTON    ORUS,,Debit Card,206.83
20170415 642246 4000 2017041525623,4/15/2017,4/15/2017,Credit,40,,339454708,Deposit Transfer To 4076823,Transfer,,208.82
20170415 642246 4000 2017041525622,4/15/2017,4/15/2017,Credit,40,,339454137,Deposit Transfer To 4076823,Transfer,,168.82
20170415 642246 21772 2017041525621,4/15/2017,4/15/2017,Debit,-217.72,,339453020,POS Transaction 9115596 WINCO FOO 7330 Nw Butl Hillsboro    ORUS,,Debit Card,128.82
20170415 642246 250 2017041525620,4/15/2017,4/15/2017,Debit,-2.5,,339453021,POS Transaction OREGON PARKING PORTLAN 1225 FERRY ST SE # U   SALEM        O,,Debit Card,346.54
20170415 642246 150 2017041525619,4/15/2017,4/15/2017,Debit,-1.5,,339453022,POS Transaction OREGON PARKING PORTLAN 1225 FERRY ST SE # U   SALEM        O,,Debit Card,349.04
20170415 642246 1463 2017041525618,4/15/2017,4/15/2017,Debit,-14.63,,339453023,POS Transaction NEW SEASON MARKET -#3 1453 NE 61ST AVE       HILLSBORO    OR,,Debit Card,350.54
20170415 642246 250 2017041525617,4/15/2017,4/15/2017,Debit,-2.5,,339453024,POS Transaction OREGON PARKING PORTLAN 1225 FERRY ST SE # U   SALEM        O,,Debit Card,365.17
20170415 642246 299 2017041525616,4/15/2017,4/15/2017,Debit,-2.99,,339453025,POS Transaction Amazon Video On Demand 440 Terry Ave N        AMZN.COM/billW,Shopping,Debit Card,367.67
20170415 642246 100 2017041525615,4/15/2017,4/15/2017,Debit,-1,,339453026,POS Transaction CITY OF PORTLAND DEPT 1120 SW 5TH AVE STE    PORTLAND     OR,,Debit Card,370.66
20170415 642246 799 2017041525614,4/15/2017,4/15/2017,Debit,-7.99,,339453027,POS Transaction MASON ROW LTD 3110 PAYNE AVE         216-2411477  OHUS,,Debit Card,371.66
20170415 642246 300 2017041525613,4/15/2017,4/15/2017,Debit,-3,,339367379,POS Transaction CITY OF PORTLAND DEPT 1120 SW 5TH AVE STE    PORTLAND     OR,,Debit Card,379.65
20170415 642246 250 2017041525612,4/15/2017,4/15/2017,Debit,-2.5,,339367380,POS Transaction CITY OF PORTLAND DEPT 1120 SW 5TH AVE STE    PORTLAND     OR,,Debit Card,382.65
20170415 642246 700 2017041525611,4/15/2017,4/15/2017,Debit,-7,,339367381,POS Transaction SQU*SQ *PUBLIC DOMAIN 900-936 Southwest WashiPortland     OR,,Debit Card,385.15
20170415 642246 794 2017041525610,4/15/2017,4/15/2017,Debit,-7.94,,339367382,POS Transaction QUALITY FOOD CEN 7525 SW BARNES RD      PORTLAND     ORUS,,Debit Card,392.15
20170414 642246 13966 2017041425608,4/14/2017,4/14/2017,Debit,-139.66,,339367383,ACH Debit PROG UNIVERSAL BRANCH16DEBIT  ACH - INS PREM,,ACH,400.09
20170414 642246 1998 2017041425607,4/14/2017,4/14/2017,Debit,-19.98,,339367384,POS Transaction BEST BUY      0001491 18085 NW EVERGREEN PKWYHILLSBORO    OR,,Debit Card,539.75
20170414 642246 2878 2017041425606,4/14/2017,4/14/2017,Debit,-28.78,,339367385,POS Transaction 300000064127 664 /2OR009 SEES CAND BEAVERTON    ORUS,,Debit Card,559.73
20170414 642246 4000 2017041425605,4/14/2017,4/14/2017,Debit,-40,,339367386,POS Transaction ARCO CORNELL 06501 15320 NW CORNELL RD    BEAVERTON    ORUS,,Debit Card,588.51
20170413 642246 3190 2017041325604,4/13/2017,4/13/2017,Check,-31.9,6109,339367387,Check #6109,,Checks,628.51
20170413 642246 225 2017041325603,4/13/2017,4/13/2017,Debit,-2.25,,339367388,POS Transaction OREGON PARKING PORTLAN 1225 FERRY ST SE # U   SALEM        O,,Debit Card,660.41
20170413 642246 225 2017041325602,4/13/2017,4/13/2017,Debit,-2.25,,339367389,POS Transaction OREGON PARKING PORTLAN 1225 FERRY ST SE # U   SALEM        O,,Debit Card,662.66
20170413 642246 225 2017041325601,4/13/2017,4/13/2017,Debit,-2.25,,339367390,POS Transaction OREGON PARKING PORTLAN 1225 FERRY ST SE # U   SALEM        O,,Debit Card,664.91
20170413 642246 1000 2017041325600,4/13/2017,4/13/2017,Debit,-10,,339367391,POS Transaction UDEMY.COM 360 3RD ST # 400       8888385432   CAUS,,Debit Card,667.16
20170413 642246 3000 2017041325599,4/13/2017,4/13/2017,Debit,-30,,338682630,Withdrawal Transfer From 4076823,Transfer,Withdrawal,677.16
20170413 642246 100 2017041325598,4/13/2017,4/13/2017,Debit,-1,,338682483,POS Transaction SQUARE *SQ *CAFE 8 800 NE Oregon Street   Portland     ORUS,,Debit Card,707.16
20170413 642246 2599 2017041325597,4/13/2017,4/13/2017,Debit,-25.99,,338682484,POS Transaction  AMAZON.COM             SEATTLE      WAUS,,Debit Card,708.16
20170413 642246 746 2017041325594,4/13/2017,4/13/2017,Debit,-7.46,,338572465,POS Transaction QUALITY FOOD CEN 7525 SW BARNES RD      PORTLAND     ORUS,,Debit Card,789.15
20170412 642246 3000 2017041225596,4/12/2017,4/12/2017,Debit,-30,,338572841,Withdrawal Transfer From 4076823,Transfer,Withdrawal,734.15
20170412 642246 2500 2017041225595,4/12/2017,4/12/2017,Check,-25,6063,338572464,Check #6063,,Checks,764.15
20170412 642246 100 2017041225593,4/12/2017,4/12/2017,Debit,-1,,338497761,POS Transaction SQUARE *SQ *CAFE 8 800 NE Oregon Street   Portland     ORUS,,Debit Card,796.61
20170412 642246 469 2017041225592,4/12/2017,4/12/2017,Debit,-4.69,,338497762,POS Transaction QUALITY FOOD CEN 7525 SW BARNES RD      PORTLAND     ORUS,,Debit Card,797.61
20170411 642246 1000 2017041125591,4/11/2017,4/11/2017,Check,-10,6112,338497763,Check #6112,,Checks,802.3
20170411 642246 1379 2017041125590,4/11/2017,4/11/2017,Debit,-13.79,,338497764,POS Transaction  AMAZON.COM             SEATTLE      WAUS,,Debit Card,812.3
20170411 642246 539 2017041125589,4/11/2017,4/11/2017,Debit,-5.39,,338497765,POS Transaction  CHEVRON/CARTER'S FOODMAPORTLAND     ORUS,,Debit Card,826.09
20170411 642246 700 2017041125588,4/11/2017,4/11/2017,Debit,-7,,338497766,POS Transaction CTY CTR PARKNG 061018 600 NE GRAND AVE       PORTLAND     OR,,Debit Card,831.48
20170411 642246 499 2017041125587,4/11/2017,4/11/2017,Debit,-4.99,,338497767,POS Transaction Amazon Services-Kindle 440 Terry Ave N        866-321-8851 W,Shopping,Debit Card,838.48
20170411 642246 995 2017041125586,4/11/2017,4/11/2017,Debit,-9.95,,338497768,POS Transaction ABV PUBLIC HOUSE MAINB 23588 NW Clara Ln      HILLSBORO    O,,Debit Card,843.47
20170410 642246 51700 2017041025585,4/10/2017,4/10/2017,Check,-517,6064,338497769,Check #6064,,Checks,853.42
20170410 642246 3485 2017041025584,4/10/2017,4/10/2017,Debit,-34.85,,338497770,POS Transaction WILD WASABE 2330 NW THURMAN ST     PORTLAND     ORUS,,Debit Card,1370.42
20170410 642246 300 2017041025583,4/10/2017,4/10/2017,Debit,-3,,338497771,POS Transaction AVA - 3 - TIMERLAND 230 NW LOST SPRINGS TERPORTLAND     ORUS,,Debit Card,1405.27
20170410 642246 800 2017041025582,4/10/2017,4/10/2017,Debit,-8,,338497772,POS Transaction LAURELHURST THEATER & 2735 E BURNSIDE ST     00001        OR,,Debit Card,1408.27
20170410 642246 3937 2017041025581,4/10/2017,4/10/2017,Debit,-39.37,,338497773,POS Transaction FRED M FUEL #9661 Q76 22075 NW IMBRIE DR     HILLSBORO    OR,,Debit Card,1416.27
20170410 642246 2200 2017041025580,4/10/2017,4/10/2017,Debit,-22,,338497774,POS Transaction LAURELHURST THEATER 2735 E BURNSIDE ST     PORTLAND     ORUS,,Debit Card,1455.64
20170410 642246 900 2017041025579,4/10/2017,4/10/2017,Debit,-9,,338497775,Withdrawal Transfer From 4076823 9,Transfer,Withdrawal,1477.64
20170410 642246 349 2017041025578,4/10/2017,4/10/2017,Debit,-3.49,,338497776,POS Transaction QUALITY FOOD CEN 7525 SW BARNES RD      PORTLAND     ORUS,,Debit Card,1486.64
20170409 642246 1000 2017040925577,4/9/2017,4/9/2017,Debit,-10,,337527421,Withdrawal Transfer From 4076823,Transfer,Withdrawal,1490.13
20170409 642246 1399 2017040925576,4/9/2017,4/9/2017,Debit,-13.99,,337527272,POS Transaction 225179145993 BETHANY NURSERY        PORTLAND     ORUS,,Debit Card,1500.13
20170409 642246 1000 2017040925575,4/9/2017,4/9/2017,Debit,-10,,337491749,Withdrawal Transfer From 4076823,Transfer,Withdrawal,1514.12
20170409 642246 17238 2017040925574,4/9/2017,4/9/2017,Debit,-172.38,,337491544,POS Transaction 9115596 WINCO FOO 7330 Nw Butl Hillsboro    ORUS,,Debit Card,1524.12
20170409 642246 10000 2017040925573,4/9/2017,4/9/2017,Debit,-100,,337428741,Withdrawal Transfer From 4076823,Transfer,Withdrawal,1696.5
20170409 642246 800 2017040925572,4/9/2017,4/9/2017,Debit,-8,,337428623,Withdrawal Transfer From 4076823,Transfer,Withdrawal,1796.5
20170409 642246 1500 2017040925571,4/9/2017,4/9/2017,Debit,-15,,337348001,Withdrawal Transfer From 4076823,Transfer,Withdrawal,1804.5
20170409 642246 871 2017040925570,4/9/2017,4/9/2017,Debit,-8.71,,337347855,POS Transaction QUALITY FOOD CEN 7525 SW BARNES RD      PORTLAND     ORUS,,Debit Card,1819.5
20170408 642246 3977 2017040825569,4/8/2017,4/8/2017,Debit,-39.77,,337347856,POS Transaction 225179141992 DENNIS SEVEN DEES CEDA PORTLAND     ORUS,,Debit Card,1828.21
20170408 642246 904 2017040825568,4/8/2017,4/8/2017,Debit,-9.04,,337347857,POS Transaction NEW SEASON MARKET -#3 1453 NE 61ST AVE       HILLSBORO    OR,,Debit Card,1867.98
20170408 642246 225 2017040825567,4/8/2017,4/8/2017,Debit,-2.25,,337347858,POS Transaction OREGON PARKING PORTLAN 1225 FERRY ST SE # U   SALEM        O,,Debit Card,1877.02
20170408 642246 4000 2017040825566,4/8/2017,4/8/2017,Debit,-40,,337347859,POS Transaction ARCO CORNELL 06501 15320 NW CORNELL RD    BEAVERTON    ORUS,,Debit Card,1879.27
20170408 642246 1800 2017040825565,4/8/2017,4/8/2017,Debit,-18,,337347860,POS Transaction AMZN KINDLE PAYMENT 86 440 TERRY AVE N        866-216-1072 W,,Debit Card,1919.27
20170408 642246 100 2017040825564,4/8/2017,4/8/2017,Debit,-1,,337347861,POS Transaction SQUARE *SQ *CAFE 8 800 NE Oregon Street   Portland     ORUS,,Debit Card,1937.27
20170408 642246 1077 2017040825562,4/8/2017,4/8/2017,Debit,-10.77,,337347863,POS Transaction TARGET T-091 18101 NW Evergreen PkwyBeaverton    ORUS,Shopping,Debit Card,1941.15
20170408 642246 2000 2017040825561,4/8/2017,4/8/2017,Credit,20,,337347864,ATM Deposit FIRST TECH 17877 NW EVERGREEN PKWYBEAVERTON    ORUS,,Debit Card,1951.92
20170407 642246 288 2017040725563,4/7/2017,4/7/2017,Check,-2.88,6108,337347862,Check #6108,,Checks,1938.27
20170407 642246 100 2017040725560,4/7/2017,4/7/2017,Debit,-1,,337347865,ACH Debit PAYPAL INSTANT TRANSFER - INST XFER,Transfer,ACH,1931.92
20170407 642246 225 2017040725559,4/7/2017,4/7/2017,Debit,-2.25,,336968623,POS Transaction OREGON PARKING PORTLAN 1225 FERRY ST SE # U   SALEM        O,,Debit Card,1932.92
20170407 642246 1000 2017040725558,4/7/2017,4/7/2017,Debit,-10,,336968624,POS Transaction CHEVRON 0200496 11015 SW CANYON RD     BEAVERTON    ORUS,Auto & Transport,Debit Card,1935.17
20170407 642246 455 2017040725557,4/7/2017,4/7/2017,Debit,-4.55,,336968625,POS Transaction QUALITY FOOD CEN 7525 SW BARNES RD      PORTLAND     ORUS,,Debit Card,1945.17
20170407 642246 1000 2017040725556,4/7/2017,4/7/2017,Debit,-10,,336819210,Withdrawal Transfer From 4076823,Transfer,Withdrawal,1949.72
20170407 642246 5000 2017040725555,4/7/2017,4/7/2017,Debit,-50,,336819094,Withdrawal Transfer From 4076823 Scheduled Recurring Transfer,Transfer,Withdrawal,1959.72
20170407 642246 1360 2017040725554,4/7/2017,4/7/2017,Debit,-13.6,,336819095,POS Transaction QUALITY FOOD CEN 7525 SW BARNES RD      PORTLAND     ORUS,,Debit Card,2009.72
20170406 642246 158470 2017040625553,4/6/2017,4/6/2017,Debit,-1584.7,,336819096,ACH Debit WF HOME MTG ACH - AUTO PAY,,ACH,2023.32
20170406 642246 31996 2017040625552,4/6/2017,4/6/2017,Debit,-319.96,,336819097,ACH Debit MULTNOMAH ATHLET FIRST TECH FCU B - BILL PAYMT,,ACH,3608.02
20170406 642246 25460 2017040625551,4/6/2017,4/6/2017,Debit,-254.6,,336819098,ACH Debit USAA P&C EXT  - AUTOPAY,,ACH,3927.98
20170406 642246 2650 2017040625550,4/6/2017,4/6/2017,Debit,-26.5,,336819099,POS Transaction ODOT DMV 503 945 5 10280 SW PARK WAY      PORTLAND     ORUS,,Debit Card,4182.58
20170406 642246 700 2017040625549,4/6/2017,4/6/2017,Debit,-7,,336819100,POS Transaction CTY CTR PARKNG 061018 600 NE GRAND AVE       PORTLAND     OR,,Debit Card,4209.08
20170406 642246 2000 2017040625548,4/6/2017,4/6/2017,Debit,-20,,336497202,Withdrawal Transfer From 4076823 For a car budget,Transfer,Withdrawal,4216.08
20170406 642246 129 2017040625547,4/6/2017,4/6/2017,Debit,-1.29,,336497203,POS Transaction APL* ITUNES.COM/BILL 1 Infinite Loop        866-712-7753 CAU,,Debit Card,4236.08
20170406 642246 4191 2017040625546,4/6/2017,4/6/2017,Debit,-41.91,,336394682,POS Transaction  AMAZON.COM             SEATTLE      WAUS,,Debit Card,4237.37
20170406 642246 1480 2017040625545,4/6/2017,4/6/2017,Debit,-14.8,,336394683,POS Transaction QUALITY FOOD CEN 7525 SW BARNES RD      PORTLAND     ORUS,,Debit Card,4279.28
20170405 642246 26639 2017040525544,4/5/2017,4/5/2017,Debit,-266.39,,336394684,ACH Debit AT&T / SBC FIRST TECH FCU B - BILL PAYMT,Bills & Utilities,ACH,4294.08
20170405 642246 19665 2017040525543,4/5/2017,4/5/2017,Debit,-196.65,,336394685,ACH Debit COMCAST - BEAVER FIRST TECH FCU B - BILL PAYMT,,ACH,4560.47
20170405 642246 18665 2017040525542,4/5/2017,4/5/2017,Debit,-186.65,,336394686,ACH Debit PORTLAND GENERAL FIRST TECH FCU B - BILL PAYMT,,ACH,4757.12
20170405 642246 11505 2017040525541,4/5/2017,4/5/2017,Debit,-115.05,,336394687,ACH Debit NW NATURAL GAS FIRST TECH FCU B - BILL PAYMT,,ACH,4943.77
20170405 642246 2092 2017040525540,4/5/2017,4/5/2017,Debit,-20.92,,336394688,ACH Debit WALKER GARBAGE S FIRST TECH FCU B - BILL PAYMT,,ACH,5058.82
20170405 642246 225 2017040525539,4/5/2017,4/5/2017,Debit,-2.25,,336394689,POS Transaction OREGON PARKING PORTLAN 1225 FERRY ST SE # U   SALEM        O,,Debit Card,5079.74
20170405 642246 175 2017040525538,4/5/2017,4/5/2017,Debit,-1.75,,336394690,POS Transaction OREGON PARKING PORTLAN 1225 FERRY ST SE # U   SALEM        O,,Debit Card,5081.99
20170405 642246 2500 2017040525537,4/5/2017,4/5/2017,Debit,-25,,336394691,POS Transaction 21ST AVENUE BICYCLES 916 NW 21ST AVE        PORTLAND     ORU,,Debit Card,5083.74
20170405 642246 600 2017040525536,4/5/2017,4/5/2017,Debit,-6,,336394692,POS Transaction QUALITY FOOD CEN 7525 SW BARNES RD      PORTLAND     ORUS,,Debit Card,5108.74
20170405 642246 448 2017040525533,4/5/2017,4/5/2017,Debit,-4.48,,335973385,POS Transaction QUALITY FOOD CEN 7525 SW BARNES RD      PORTLAND     ORUS,,Debit Card,5149.74
20170404 642246 1000 2017040425535,4/4/2017,4/4/2017,Debit,-10,,335976076,Withdrawal Transfer From 4076823,Transfer,Withdrawal,5114.74
20170404 642246 2500 2017040425534,4/4/2017,4/4/2017,Debit,-25,,335973582,Withdrawal Transfer From 4076823,Transfer,Withdrawal,5124.74
20170404 642246 225 2017040425532,4/4/2017,4/4/2017,Debit,-2.25,,335973386,POS Transaction OREGON PARKING PORTLAN 1225 FERRY ST SE # U   SALEM        O,,Debit Card,5154.22
20170404 642246 150 2017040425531,4/4/2017,4/4/2017,Debit,-1.5,,335973387,POS Transaction OREGON PARKING PORTLAN 1225 FERRY ST SE # U   SALEM        O,,Debit Card,5156.47
20170404 642246 1000 2017040425530,4/4/2017,4/4/2017,Debit,-10,,335973388,POS Transaction CHEVRON 0200496 11015 SW CANYON RD     BEAVERTON    ORUS,Auto & Transport,Debit Card,5157.97
20170404 642246 225 2017040425529,4/4/2017,4/4/2017,Debit,-2.25,,335973389,POS Transaction STARBUCKS STORE 00424 22000 Willamette Drive WEST LINN    OR,Food & Dining,Debit Card,5167.97
20170404 642246 2322 2017040425528,4/4/2017,4/4/2017,Debit,-23.22,,335973390,POS Transaction MARKET OF CHOICE #2 250 NW LOST SRPINGS TERPORTLAND     ORUS,,Debit Card,5170.22
20170403 642246 15159 2017040325527,4/3/2017,4/3/2017,Debit,-151.59,,335973391,POS Transaction 21ST AVENUE BICYCLES 916 NW 21ST AVE        PORTLAND     ORU,,Debit Card,5193.44
20170403 642246 2500 2017040325526,4/3/2017,4/3/2017,Debit,-25,,335973392,POS Transaction GROUPON INC 600 W Chicago Ave      877-788-7858 ILUS,,Debit Card,5345.03
20170403 642246 1050 2017040325525,4/3/2017,4/3/2017,Debit,-10.5,,335973393,POS Transaction NY TIMES NATL SALES 620 Eighth Ave 22nd Fl 800-698-4637 NYUS,,Debit Card,5370.03
20170403 642246 338 2017040325524,4/3/2017,4/3/2017,Debit,-3.38,,335973394,ACH Debit PAYPAL INSTANT TRANSFER - INST XFER,Transfer,ACH,5380.53
20170403 642246 1000 2017040325523,4/3/2017,4/3/2017,Debit,-10,,335973395,POS Transaction 76 - 76 OF GREENBERG 10775 SW GREENBURG RD  TIGARD       ORU,,Debit Card,5383.91
20170403 642246 3995 2017040325522,4/3/2017,4/3/2017,Debit,-39.95,,335973396,POS Transaction  AMAZON.COM             SEATTLE      WAUS,,Debit Card,5393.91
20170403 642246 99 2017040325521,4/3/2017,4/3/2017,Debit,-0.99,,335973397,POS Transaction AMAZON SERVICES-KINDLE 440 TERRY AVE N        866-216-1072 W,Shopping,Debit Card,5433.86
20170403 642246 40000 2017040325520,4/3/2017,4/3/2017,Debit,-400,,335973398,Withdrawal Transfer From 4076823 Scheduled Recurring Transfer,Transfer,Withdrawal,5434.85
20170403 642246 900 2017040325519,4/3/2017,4/3/2017,Debit,-9,,335973399,Withdrawal Transfer From 4076823 9,Transfer,Withdrawal,5834.85
20170403 642246 1999 2017040325518,4/3/2017,4/3/2017,Debit,-19.99,,335270371,POS Transaction 334007973889 HARBOR FREIGHT TOOLS 2 PORTLAND     ORUS,,Debit Card,5843.85
20170402 642246 40000 2017040225517,4/2/2017,4/2/2017,Debit,-400,,335155061,Withdrawal Transfer From 4076823,Transfer,Withdrawal,5863.84
20170402 642246 16243 2017040225516,4/2/2017,4/2/2017,Debit,-162.43,,335153505,POS Transaction 90739714 WINCO #02 7500 DARTMOU Tigard       ORUS,,Debit Card,6263.84
20170402 642246 800 2017040225515,4/2/2017,4/2/2017,Debit,-8,,335092158,Withdrawal Transfer From 4076823,Transfer,Withdrawal,6426.27
20170402 642246 2351 2017040225513,4/2/2017,4/2/2017,Debit,-23.51,,335092160,POS Transaction 1405308 QUALITY F 7525 SW BARN PORTLAND     ORUS,,Debit Card,6434.27
20170401 642246 100 2017040125512,4/1/2017,4/1/2017,Debit,-1,,334936265,POS Transaction MCDONALD'S F33135 72485 HWY 331          PENDLETON    ORUS,Food & Dining,Debit Card,6457.78
20170401 642246 757 2017040125511,4/1/2017,4/1/2017,Debit,-7.57,,334936266,POS Transaction ARROWHEAD TRAVEL PLAZA 72485 HWY 331          PENDLeTON    O,,Debit Card,6458.78
20170401 642246 661 2017040125510,4/1/2017,4/1/2017,Debit,-6.61,,334936267,POS Transaction GENERAL STORE 3261 VILLAGE DR        TETON VILLAGEWYUS,,Debit Card,6466.35
20170401 642246 349 2017040125509,4/1/2017,4/1/2017,Debit,-3.49,,334936268,"POS Transaction Audible US 1 Washington Park, 16th888-283-5051 NJUS",,Debit Card,6472.96
20170401 642246 799 2017040125508,4/1/2017,4/1/2017,Debit,-7.99,,334936269,POS Transaction Amazon Services-Kindle 440 Terry Ave N        866-321-8851 W,Shopping,Debit Card,6476.45
20170401 642246 926 2017040125507,4/1/2017,4/1/2017,Debit,-9.26,,334936270,POS Transaction THE PIT STOP 232 N HWY 77           DECLO        IDUS,,Debit Card,6484.44
20170401 642246 949 2017040125506,4/1/2017,4/1/2017,Debit,-9.49,,334936271,POS Transaction AMAZON DIGITAL SVCS AM 440 TERRY AVE N        866-216-1072 W,Shopping,Debit Card,6493.7
20170401 642246 1601 2017040125505,4/1/2017,4/1/2017,Debit,-16.01,,334936272,POS Transaction STARBUCKS STORE 1924 10 East Broadway       JACKSON      WYU,Food & Dining,Debit Card,6503.19
20170401 642246 1423 2017040125503,4/1/2017,4/1/2017,Debit,-14.23,,334568180,POS Transaction 318424 ASPENS MARKET          WILSON       WYUS,,Debit Card,6515.45
